οὗν	noun_preposition_preposition_	ὗς_ἐν_εἰς_
σφῶϊν	pronoun_pronoun_	σύ_σφεῖς_
ἠμφιέσθαι	verb_verb_	ἀμφί-ἀμφιέννυμι_ἀμφί-ἵημι_
φωτὶ	noun_noun_	φώς_φάος_
προθέῃσι	verb_verb_verb_	προθέω_προτίθημι_προθέω1_
Ὀδίου	noun_noun_	Ὄδιος_Ὀδίος_
πειρώμενος	verb_verb_	πειράζω_πειράω_
Ἴνῶ	verb_noun_	ἰνόω_ἴνος_
πῆξε	verb_verb_	πήσσω_πήγνυμι_
ἥττα	verb_noun_	ἡττάω_ἧσσα_
λίς	noun_noun_	λίς2_λίς1_
ἄκοντες	noun_adjective_	ἄκων_ἀέκων_
εὐνῆς	noun_verb_verb_	εὐνή_εὐνάω_εὐνάζω_
ποιῶμεν	verb_verb_	ποιόω_ποιέω_
κάρτιστον	adjective_adjective_	κράτιστος_κάρτιστος_
Ἀπόρων	verb_adjective_	ἀφοράω_ἄπορος_
εἰκοστή	adjective_noun_	εἰκοστός_εἰκοστή_
τέως	adjective_adverb_	τέος_τέως_
διπλᾶ	verb_adjective_	διπλάζω_διπλόος_
τιμῆσαι	verb_verb_	τιμέω_τιμάω_
οὐρῆες	noun_noun_	οὐρεύς_ὀρεύς_
μέσῃ	adjective_noun_noun_	μέσος_μέσης_μέση_
ἄθλῶν	noun_noun_	ἆθλος_ἆθλον_
Ἔριδα	noun_noun_	ἔρις_Ἔρις_
ἀπέην	verb_verb_	ἄπειμι1_ἀφίημι_
κατακοιμήσει	verb_noun_	κατακοιμάω_κατακοίμησις_
ἤρτηται	verb_verb_	ἀρτέομαι_ἀρτάω_
λευκὰ	noun_adjective_noun_	λευκάς_λευκός_λευκόν_
κόμην	verb_noun_	κομάω_κόμη_
ἰ¨οί	noun_verb_noun_verb_	ἰός1_ἰόω_ἰός2_ἰόομαι_
διανοοῦ	verb_verb_	διανοέομαι_διανοέω_
ἐλελήκει	verb_verb_	λάσκω_λανθάνω_
χώσατο	verb_verb_	χόω_χώομαι_
ἐχολοῦτο	verb_verb_	χολόομαι_χολόω_
μένει	verb_noun_	μένω_μένος_
μ᾽	pronoun_pronoun_	ἐγώγε_ἐγώ_
Ἀριστάρχου	noun_noun_	ἀρίσταρχος_Ἀρίσταρχος_
Ἐρινύων	noun_verb_	Ἐρινύς_ἐρινύω_
πολυπίδακα	noun_adjective_	πολυπῖδαξ_πολυπίδακος_
ἐλεύσῃ	verb_noun_	ἔρχομαι_ἔλευσις_
ἀφῆκε	verb_verb_	ἀφήκω_ἀφίημι_
στρόμβου	noun_verb_	στρόμβος_στρομβόω_
Φόβῳ	noun_noun_	Φόβος_φόβος_
τριῶν	verb_verb_numeral_verb_	τριάξω_τριάζω_τρεῖς_τρίζω_
σοφισάμενοι	verb_verb_	σοφίζω_σοφίζομαι_
στᾶσα	verb_verb_	ἵστημι_στάζω_
αὐλῆς	noun_verb_	αὐλή_αὐλέω_
ἴτην	noun_verb_	ἴτης_εἶμι_
κάκιον	verb_adjective_	κηκίω_κακός_
δέξομαι	verb_verb_	δέχομαι_δείκνυμι_
ἧκεν	verb_verb_	ἥκω_ἵημι_
ἥ	article_pronoun_	ὁ_ὅς_
ὑπερῷον	adjective_noun_	ὑπερῷος_ὑπερῷον_
ὁδὲ	noun_noun_	ὁδός1_ὁδός2_
ἕνα	adjective_noun_	ἕνος_εἷς_
ἐλεήσας	verb_verb_	ἐλεέω_ἐλεάω_
ἄγω	verb_verb_	ἄγω_ἄγαμαι_
νηΐ	noun_noun_	ναῦς_Ναιάς_
δεδμήατο	verb_verb_	δέμω_δαμάζω_
ἴσας	adjective_verb_	ἴσος_οἶδα_
ποικιλίας	noun_noun_	ποικιλία_ποικιλίας_
Διονύσῳ	noun_noun_	Διόνυσος_Διονύσος_
Ἀρηΐθοος	noun_adjective_	Ἀρηΐθοος_Ἀρηίθοος_
γεγωνέμεν	verb_verb_	γεγωνέω_γέγωνα_
ἀχρήϊον	adjective_adjective_	ἀχρεῖος_ἀχρήιος_
ὑποκατιών	κατά-εἰμ_verb_	ὑπό_ὑπό-κάτειμι_
πέφυκε	verb_verb_	φύω_φύζω_
μαχέοιντο	verb_verb_verb_	μάχομαι_σέω_συμμαχέω_
γραφαί	noun_noun_	γραφής_γραφή_
Φρύγες	noun_verb_	Φρύξ_φρύγω_
σέλα	verb_noun_	σελάω_σέλας_
Χρύσιππος	noun_noun_	Χρυσίππος_Χρύσιππος_
Ἔρεβος	noun_noun_	ἔρεβος_Ἔρεβος_
χρέα	noun_noun_noun_	χρέος_χρῆ_χρέα_
πανουργότατον	adjective_adjective_	πάνουργος_πανοῦργος_
ἠελίου	noun_noun_	ἠέλιος_ἥλιος_
συζυγίας	adjective_noun_	συζύγιος_συζυγία_
ἁπάτην	noun_verb_	ἀπάτη_ἀπατάω_
ἑξείης	adverb_adverb_	ἑξείης_ἑξῆς_
περιγραφῇ	verb_noun_	περιγράφω_περιγραφή_
θεμείλια	noun_noun_	θεμείλια_θέμεθλα_
μερῶν	noun_noun_	μέρα_μέρος_
ὥς	pronoun_conjunction_	ὅς_ὡς_
πεινῶν	noun_verb_verb_	πεῖνα_πεινάω_πεινέω_
ζῴοις	noun_noun_	ζώιον_ζῷον_
ἤγουν	conjunction_verb_	ἤγουν_ἀγάω_
Εὐριπίδῃ	noun_noun_	Εὐριπίδης_εὐριπίδης_
πλησίον	adverb_verb_	πλησίος_πίμπλημι_
Ξάνθου	noun_verb_	Ξάνθος_ξανθόω_
σοῖο	adjective_verb_	σός_σέω_
μόνως	adjective_adverb_verb_	μόνος_μόνως_μονόω_
ὕστερον	noun_adjective_	ὕστερον_ὕστερος_
κραυγῆς	verb_noun_	κραυγάζω_κραυγή_
βλάψει	noun_verb_	βλάψις_βλάπτω_
Ὕδρας	noun_noun_	ὕδρα_Ὕδρα_
αὐλῶν	noun_verb_noun_	αὐλός_αὐλέω_αὐλή_
ὕλην	noun_verb_	ὕλη_ὑλάω_
φρόνησιν	noun_noun_	φρόνησις_φρόνις_
Ἤλου	noun_verb_noun_	ἦλον_ἀλόω_ἦλος_
κύνα	noun_verb_	κύων_κυνάω_
φοιτῶσαν	verb_verb_	φοιτάω_φοιτάζω_
θείομεν	verb_verb_	τίθημι_θέω_
ἔδον	verb_verb_	δίδωμι_ἔδω_
νεύρων	verb_noun_	νευρόω_νεῦρον_
ἀμβροσίην	adjective_noun_noun_	ἀμβρόσιος_ἀμβροσίη_ἀμβροσία_
πεφοινιγμένος	verb_verb_	φοινίσσω_φοινίζω_
Πύρρα	noun_noun_	πύρρα_Πύρρα_
κέηται	verb_verb_	κεῖμαι_κέω_
νευρήν	noun_noun_	νευρή_νευρά_
φυλάκων	noun_noun_	φύλαξ_φυλακός_
πολέμους	verb_noun_	πολεμόω_πόλεμος_
ἀντιάσας	verb_verb_	ἀντιάω_ἀντιάζω_
χείρων	verb_adjective_	χειρόω_χείρων_
λεγομένους	verb_verb_verb_	λέγω3_λέγω2_λέγω1_
κύριόν	noun_verb_	κύριος_κυρέω_
μοιρῶν	noun_verb_verb_	μοῖρα_μοιράζω_μοιράω_
τέλη	noun_verb_	τέλος_τελέω_
ἀξία	adjective_noun_verb_	ἄξιος_ἀξία_ἀξιάω_
Ἐπειὸς	adjective_adjective_	Ἐπειοί_Ἐπειός_
ἀρθεισῶν	verb_verb_	ἀραρίσκω_αἴρω_
ἀγούσῃ	verb_verb_	ἀγάω_ἄγω_
ἄχυρον	noun_noun_	ἄχυρος_ἄχυρον_
ἔμφυτον	verb_adjective_	ἐμφύω_ἔμφυτος_
Ὀδυσσείας	adjective_noun_	Ὀδύσσειος_Ὀδύσσεια_
Φοῖνιξ	noun_noun_	Φοῖνιξ_φοῖνιξ_
χαλκείῳ	adjective_noun_	χάλκειος_χαλκεῖον_
γελοία	adjective_verb_verb_	γέλοιος_γελοιάω_γελάω_
Ἄρηος	noun_noun_noun_	Ἄρις_Ἄρης_Ἄρευς_
ἐρᾶν	noun_verb_verb_	ἔρα_ἐράω2_ἐράω1_
Ἡρακλέους	noun_noun_	Ἡρακλῆς_Ἡρακλέος_
πάσαντο	verb_verb_	πάσσω_πατέομαι_
μέλη	noun_noun_	μέλη_μέλος_
διέχεεν	verb_verb_	διέχω_διαχέω_
σκληρῶς	adjective_verb_	σκληρός_σκληρόω_
ἐξαρκεῖ	adjective_verb_	ἐξαρκής_ἐξαρκέω_
μὴν	particle_noun_noun_	μήν_μείς_μής_
λεξάσθην	verb_verb_verb_	λέγω3_λέγω1_λέγω2_
ὅμοια	adjective_adjective_	ὅμοιος_ὁμοῖος_
Τηρεῖ	verb_noun_	τηρέω_Τηρεύς_
ἐμαντεύσατο	verb_verb_	μαντεύω_μαντεύομαι_
Δήλῳ	adjective_noun_	δῆλος_Δῆλος_
δειλῶν	adjective_noun_	δειλός_δείλη_
Εὐρώπης	noun_noun_	Εὐρώπης_Εὐρώπη_
Ἄρηϊ	noun_verb_verb_noun_noun_	Ἄρις_ἀείρω_αἴρω_Ἄρευς_Ἄρης_
κώπη	verb_verb_noun_	κωπέω_κωπάω_κώπη_
κεχαρισμένος	verb_verb_	χαρίζομαι_χαρίζω_
Ἀθηναίη	noun_adjective_	Ἀθήνη_Ἀθηναῖος_
τυχόν	verb_adverb_	τυγχάνω_τυχόν_
συγγενεῖς	adjective_noun_	συγγενής_συγγενεύς_
εἶθ'	adverb_verb_verb_	εἶτα_εἶμι_εἰμί_
αὖ	exclamation_adverb_	αὗ_αὖ_
κάτ'	preposition_adjective_	κατά_κάτος_
οἶσιν	noun_verb_	οἶσις_εἰμί_
ἤϊκτο	verb_verb_	ἀίσσω_ἔοικα_
οὐδ'	noun_noun_particle_	οὐδός1_οὐδός2_οὐδέ_
κοίτην	noun_verb_	κοίτη_κέω_
ὅ	article_pronoun_	ὁ_ὅς_
ὁδόν	noun_noun_	ὁδός1_ὁδός2_
λοιπάς	noun_adjective_	λοιπάς_λοιπός_
Xείρων	verb_adjective_	χειρόω_χείρων_
ποιηταὶ	noun_adjective_	ποιητής_ποιητός_
Κήρυκα	noun_noun_	κῆρυξ_Κήρυξ_
λεξάσθωσαν	verb_verb_verb_	λέγω2_λέγω1_λέγω3_
φοιτῶντε	verb_verb_	φοιτάζω_φοιτάω_
Δωριεῖς	verb_noun_	δωρίζω_Δωριεύς_
ἀπαλλάξειν	verb_verb_	ἀπαλλάσσω_ἀπαλλαξείω_
ὁρμῶ	verb_verb_verb_	ὁρμέω_ὁρμάζω_ὁρμάω_
ἠρασάμην	verb_verb_verb_verb_verb_verb_verb_	ἀράζω_ἐράομαι_ἐρέομαι_ἀρέομαι_ἐρέω_ἔραμαι_ἀράομαι_
δυσώδη	verb_adjective_	δυσωδέω_δυσώδης_
Μώμῳ	noun_noun_	μῶμος_Μῶμος_
μακράν	adjective_adverb_	μακρός_μακράν_
γύη	verb_noun_noun_	ἐγγυάω_γύης2_γύης1_
θάλειαν	noun_verb_	θάλεια_θάλλω_
Ἀρίσταρχος	noun_noun_	Ἀρίσταρχος_ἀρίσταρχος_
Ἥβην	verb_noun_noun_verb_	ἡβάω_Ἥβη_ἥβη_ἅπτω_
χολωθεὶς	verb_verb_	χολόω_χολόομαι_
μῶ	verb_noun_	μάομαι_μής_
ἐφάνησαν	verb_verb_	φαίνω_φανάω_
ὀδοῦσιν	noun_noun_	ὀδών_ὀδούς_
ἤϊε	verb_noun_verb_	εἶμι_ἤιος_ἀίω1_
κυανέῃσι	noun_adjective_verb_	Κυάνεαι_κυάνεος_κυανέω_
ἱστάμενοι	verb_verb_	ἵστημι_ἱστάω_
Διονυσίου	adjective_noun_	Διονύσιος_Διονύσιον_
ἐγχώριον	verb_adjective_	ἐγχωρέω_ἐγχώριος_
πὰρα	preposition_noun_	παρά_πῆρος_
λέγών	verb_verb_adjective_verb_	λέγω3_λέγω2_λέγος_λέγω1_
ὥρμησεν	verb_verb_	ὁρμάω_ὁρμέω_
χρᾶ	verb_verb_noun_verb_	χράω2_χράω1_χρῆ_χραύω_
ἐφορῶντι	verb_verb_	ἐφοράω_ἐποράω_
αὐξήσεις	verb_noun_	αὐξάνω_αὔξησις_
καιροῖς	noun_verb_	καιρός_καιρόω_
κυλλοποδίων	noun_noun_	κυλλοποδίων_Κυλλοποδίων_
σπείους	noun_noun_	σπεῖος_σπέος_
πιστὸν	adjective_noun_adjective_	πιστός1_πιστόν_πιστός2_
μέσω	noun_adjective_verb_	μέσης_μέσος_μεσόω_
καπνοῦ	noun_verb_	καπνός_καπνόομαι_
Τίτανος	noun_noun_	τίτανος_Τίτανος_
Κρίνιδι	noun_noun_	Κρῖνις_Κρίνις_
Ῥοδίους	adjective_adjective_	Ῥοδιακός_Ῥόδιος_
θερμοῦ	adjective_verb_	θερμός_θερμόω_
ἀρσενικοῦ	adjective_noun_	ἀρσενικός_ἀρσενικόν_
Αἰθιοπίαν	noun_adjective_	Αἰθιοπία_Αἰθιόπιος_
θεμελίους	adjective_verb_	θεμέλιος_θεμελιόω_
Ἀθήνης	noun_noun_	Ἀθήνευς_Ἀθῆναι_
ἔραμαι	verb_verb_	ἔραμαι_ἐράομαι_
ἤδη	noun_adverb_	ἦδος_ἤδη_
ἀκριβοῦς	adjective_verb_	ἀκριβής_ἀκριβόω_
χαλεπῇ	verb_adjective_	χαλέπτω_χαλεπός_
ἀνδρείαν	noun_adjective_	ἀνδρεία_ἀνδρεῖος_
δῆ	verb_verb_verb_	δέω2_δέω1_δεῖ_
κεχαρισμένη	verb_verb_	χαρίζομαι_χαρίζω_
λέγειν	verb_verb_verb_	λέγω2_λέγω1_λέγω3_
καθέζοιτο	verb_verb_	κατά-ἕζομαι_κατά-καθέζομαι_
ἅνδρα	verb_noun_	ἐνιδρόω_ἀνήρ_
ἐπισπεῖν	verb_verb_	ἐφέπω_ἐπισπάω_
ἐνέδραν	verb_noun_	ἐνιδρόω_ἐνέδρα_
δύσιν	noun_verb_	δύσις_δύω2_
διαλελυμένως	verb_adverb_	διαλύω_διαλελυμένως_
ὀλίγων	adjective_verb_	ὀλίγος_ὀλιγόω_
φίλης	verb_adjective_	φιλέω_φίλος_
Κρόνος	noun_noun_	Κρόνος_κρόνος_
πολιῆτις	noun_noun_	πολιῆτις_πολίτης_
ὑστάταις	adjective_adjective_	ὕστατος_ὕστερος_
Μαία	adjective_noun_noun_	Μάιος_Μαῖα_μαῖα_
ἡμέραν	adjective_noun_	ἥμερος_ἡμέρα_
ἐπαύλεις	verb_noun_	ἐπαυλέω_ἔπαυλις_
τὶ	pronoun_irregular_	τις_τίς_
ἀλλοτρίων	adjective_verb_	ἀλλότριος_ἀλλοτριόω_
εἴαθ'	verb_verb_	ἐάω_εἰμί_
ἰῷ	noun_noun_adjective_	ἰός2_ἰός1_εἷς_
θᾶττον	adjective_adjective_	ταχύς_θάσσων_
ἄσατο	verb_verb_	ἄω1_ἀάω_
μικρός	adjective_adjective_	μικρός_σμικρός_
εἰλούμενον	verb_verb_	εἴλω_εἰλέω_
ἀπολούσῃ	verb_noun_verb_	ἀπόλλυμι_ἀπόλουσις_ἀπολούω_
ἀρσενικόν	noun_adjective_	ἀρσενικόν_ἀρσενικός_
μείλια	noun_noun_	μείλιον_μείλια_
ἐμοῖς	verb_adjective_	ἐμέω_ἐμός_
κραδίῃ	noun_noun_	κραδίας_καρδία_
Θέμιστι	noun_noun_	Θέμις_Θέμιστις_
ᾠήθησαν	verb_verb_	οἰάω_οἴομαι_
ἔρω	noun_verb_	ἔρος1_ἔραμαι_
πλευρῶν	noun_noun_	πλευρόν_πλευρά_
παραζεύξεις	noun_verb_	παράζευξις_παραζεύγνυμι_
Ταύρου	noun_noun_	ταῦρος_Ταῦρος_
ἔλαχον	verb_adjective_	λαγχάνω_ἔλαχος_
ὅλως	adjective_adjective_	ὅλοξ_ὅλος_
τιμήσωμεν	verb_verb_	τιμάω_τιμέω_
Κύκνω	noun_noun_	Κύκνος_κύκνος_
εἴη	verb_verb_	ἐάω_εἰμί_
ὁδοὶ	noun_verb_noun_	ὁδός2_ὁδόω_ὁδός1_
παντοδαπῶν	adjective_adjective_	παντοδαπής_παντοδαπός_
ἔσχηκεν	verb_verb_	ἔχω_σχάω_
μικρὰ	adjective_adjective_	σμικρός_μικρός_
μόριον	verb_noun_adjective_	μορέω_μόριον_μόριος_
πτῆται	verb_verb_	πέτομαι_πτάζω_
φάλαρα	adjective_noun_noun_	φάλαρος_φάλαρον_φάλαρα_
ὑπέρτερος	adjective_adjective_	ὑπέρτερος_ὑπέρ_
μηκώμεναι	verb_verb_	μηκάζω_μηκάομαι_
ἔναυλον	noun_noun_adjective_	ἔναυλος1_ἔναυλον_ἔναυλος2_
νόθους	verb_adjective_	νοθόω_νόθος_
ἔσσεαι	verb_verb_	εἰμί_ἔσσομαι_
ἀποτελέσῃ	noun_verb_	ἀποτέλεσις_ἀποτελέω_
κοιλοτέρου	adjective_adjective_	κοῖλος_κόιλος_
ποίας	adjective_noun_	ποῖος_πόα_
ὑπακουστέον	adjective_adjective_	ὑπακουστέος_ὑπακουστέον_
σεῦ	verb_pronoun_	σέω_σύ_
διανοούμενον	verb_verb_	διανοέομαι_διανοέω_
πρόβατ'	noun_verb_	πρόβατον_προβαίνω_
λύπη	noun_verb_	λύπη_λυπέω_
δοκῷ	noun_verb_noun_	δοκός_δοκάζω_δοκόν_
σχεδίας	adjective_noun_	σχέδιος_σχεδία_
Βῆσσαν	noun_noun_	Βῆσσα_βῆσσα_
Πλούταρχος	adjective_noun_	πλούταρχος_Πλούταρχος_
ἔναρα	adjective_noun_	ἔναρος_ἔναρα_
ἧσαι	verb_verb_verb_	ἥδομαι_ἧμαι_κάθημαι_
δεκάτου	verb_adjective_	δεκατόω_δέκατος_
νεκρῶν	verb_adjective_	νεκρόω_νεκρός_
πειρᾶντ'	verb_verb_	πειράω_πειράζω_
Αἰτωλοί	adjective_noun_	Αἰτωλός_Αἰτωλοί_
ἕρμ'	noun_noun_	ἕρμα1_ἕρμα2_
ἄφ'	preposition_noun_	ἀπό_ἄπαις_
εὐθέως	adjective_adjective_adverb_adverb_	εὐθής_εὐθύς1_εὐθέως_εὐθύς2_
ταχέως	adverb_adjective_	ταχέως_ταχύς_
δεινοῦ	verb_adjective_	δεινόω_δεινός_
αὖον	verb_verb_adjective_	αὔω2_αὔω1_αὖος_
ἀποαιρεῖσθαι	verb_verb_	ἀποαιρέομαι_ἀφαιρέω_
πιμελῆς	adjective_noun_	πιμελής_πιμελή_
Θεσσαλία	noun_noun_	Θεσσαλίη_Θεσσαλία_
Κλυταιμνήστραν	noun_noun_	Κλυταιμνήστρα_Κλυταιμνήστρη_
ὅμοιος	adjective_adjective_	ὁμοῖος_ὅμοιος_
ἀμβροσίαν	noun_noun_adjective_	ἀμβροσίη_ἀμβροσία_ἀμβρόσιος_
ζῷον	noun_noun_	ζῷον_ζώιον_
κόμης	verb_noun_noun_	κομάω_κόμη_κόμης_
φίλη	adjective_noun_verb_	φίλος_φῖλος_φιλέω_
καταγαζόμεναι	verb_verb_	κατά-ἀγάζω_κατά-ἄγαμαι_
φυτῶ	noun_adjective_	φυτόν_φυτός_
ἀμβρόσιαι	adjective_noun_	ἀμβρόσιος_ἀμβροσία_
Ἄρηα	noun_noun_noun_	Ἄρις_Ἄρης_Ἄρευς_
λέγειν	verb_verb_verb_	λέγω1_λέγω3_λέγω2_
μυθέομαι	verb_verb_	μυθέομαι_μυθέω_
σκύλων	verb_noun_	σκυλάω_σκῦλον_
δαῖτα	noun_noun_	δαίτης_δαίς3_
βιάσασθαι	verb_verb_	βιάω_βιάζω_
διαβεβαιοῦν	verb_verb_	διαβεβαιόω_διαβεβαιόομαι_
οἰκτείρει	verb_verb_verb_verb_	οἰκτείρω_ορέω_οἰκτειρέω_ʼκ̓τείρω_
νῶτον	noun_noun_	νῶτος_νῶτον_
τιμήσουσι	verb_verb_	τιμέω_τιμάω_
ἀκμῆς	verb_noun_	ἀκμάζω_ἀκμή_
ἱστᾶσι	verb_verb_	ἵστημι_ἱστάω_
ἱερέων	noun_noun_adjective_noun_	ἱεραί_ἱερή_ἱερός_ἱερά_
υἱοὶ	verb_noun_	υἱόω_υἱός_
τελείου	verb_verb_adjective_	τελειόω_τελέω_τέλειος_
Ἔννομος	adjective_noun_	ἔννομος_Ἔννομος_
Θυέστα	noun_noun_	θυέστης_Θυέστης_
Πατρόκλῳ	noun_noun_	Πάτροκλος_Πατρόκλον_
βασίλισσαν	noun_verb_noun_	βασίλισσα_βασιλίζω_βασιλεία_
πεῖσαι	noun_verb_	πεῖσα_πείθω_
ἀποστάσει	noun_verb_verb_	ἀπόστασις_ἀποστάζω_ἀφεστήξω_
ἐσπόμεθ'	verb_verb_	ἔσπον_ἕπομαι_
τῦφον	noun_verb_	τῦφος_τύφω_
Νύσῃ	noun_noun_noun_	νύσα_Νύση_Νῦσα_
Παναχαιῶν	adjective_noun_	Παναχαιός_Παναχαιοί_
ἀκτίνων	noun_adjective_	ἀκτίς_ἄκτινος_
Φοῖβε	noun_adjective_	Φοῖβος_φοῖβος_
τέλεον	verb_adjective_	τελέω_τέλειος_
διενεύσατο	verb_ἐν-εὕ_	διά-νεύω_διά_
Θεσσαλίας	noun_noun_	Θεσσαλία_Θεσσαλίη_
Ἑλικώνιον	adjective_adjective_	Ἑλικώνιος_Ἑλικών_
ἐπήγνυτο	verb_verb_	πήγνυμι_ἐπάγνυμι_
ἐδέησε	verb_verb_	δεῖ_δέω2_
ἐπολέμουν	verb_verb_	πολεμέω_πολεμόω_
Αἰγέα	noun_adjective_noun_	Αἰγεύς_αἴγεος_Αἰγίς_
περικεφαλαίας	adjective_noun_	περικεφάλαιος_περικεφαλαία_
ἴσαν	verb_adjective_verb_	εἶμι_ἴσος_οἶδα_
δυσώδεις	verb_adjective_	δυσωδέω_δυσώδης_
ποιούμενος	verb_verb_	ποιόω_ποιέω_
Βοιωτίας	noun_adjective_	Βοιωτία_Βοιώτιος_
δεινοῖς	adjective_verb_	δεινός_δεινόω_
Πόδαργε	adjective_noun_	πόδαργος_Πόδαργος_
ὁμοίοις	adjective_adjective_	ὁμοῖος_ὅμοιος_
ποιήσει	noun_verb_	ποίησις_ποιέω_
ἔδυσαν	verb_verb_	δύω2_δύω1_
ἀποφάσει	verb_noun_noun_	ἀπόφημι_ἀπόφασις1_ἀπόφασις2_
ἄμοτον	adverb_adjective_	ἄμοτον_ἄμοτος_
Ἱξίων	noun_verb_	ἵξις_ἵκω_
πρῶτόν	adjective_adjective_	πρότερος_πρῶτος_
οὕτ'	adverb_verb_conjunction_noun_noun_	ἔτι_ἵημι_ὅτε_ἔται_ἔτης_
Αἴθρῃ	noun_noun_	Αἴθρη_αἴθρη_
ἀπειλοῦντι	verb_verb_verb_	ἀπειλέω_ἀπειλέω1_ἀπειλέω2_
πολεμοῦν	verb_verb_	πολεμόω_πολεμέω_
νῆσαι	verb_verb_verb_	νέω3_νέω_νέω2_
κοῦρος	noun_noun_	κοῦρος_κόρος2_
Κλειτὸν	adjective_noun_	κλειτός_Κλειτός_
τελευτῆς	verb_noun_	τελευτάω_τελευτή_
θεοσεβεῖς	adjective_verb_	θεοσεβής_θεοσεβέω_
Λυκίαν	noun_adjective_	Λυκία_Λύκιος_
Κηρύκων	noun_noun_noun_	κῆρυξ_Κήρυξ_Κήρυκες_
Κλειοῖ	verb_noun_	κλῄζω1_Κλειώ_
ὁπλῶν	noun_verb_	ὁπλή_ὁπλέω_
δαιμόνι'	noun_adjective_	δαιμόνιον_δαιμόνιος_
κρείττους	adjective_verb_	κρείσσων_κρεισσόω_
ἐλαίαν	noun_verb_	ἐλαία_ἐλαιάω_
λέγων	verb_verb_adjective_verb_	λέγω3_λέγω2_λέγος_λέγω1_
δοκεῖ	noun_verb_	δοκεύς_δοκέω_
δασέων	adjective_noun_	δασύς_δάσος_
τέλει	verb_noun_	τελέω_τέλος_
Εὐριπίδῃ	noun_noun_	εὐριπίδης_Εὐριπίδης_
βάτην	verb_noun_	βαίνω_βάτης_
ἤγερθεν	verb_verb_	ἐγείρω_ἀγείρω_
ξανθοὶ	adjective_verb_	ξανθός_ξανθόω_
ἀρητὸν	adjective_adjective_	ἀρατός_ἀρητός_
διαμπερὲς	adverb_adjective_	διαμπερές_διαμπερής_
Φήμιον	noun_noun_	φήμιος_Φήμιος_
τελεῖ	verb_verb_	τελέω_τέλλω_
εἴρας	noun_verb_	εἴρη_εἴρω_
τίσωσι	verb_verb_	τίνω_τίζω_
τελείως	adjective_verb_	τέλειος_τελειόω_
φρίκην	noun_noun_	φρίκη_φρῖκος_
βολῆς	noun_verb_	βολή_βολέω_
γυμνοῖς	verb_adjective_	γυμνόω_γυμνός_
διπλοῦς	verb_adjective_	διπλόω_διπλόος_
Πέπλῳ	noun_adjective_	πέπλος_πεπλος_
μεταγενεστέρας	adjective_adjective_	μεταγενέστερος_μεταγενής_
ἠπείλησεν	verb_verb_verb_	ἐπειλέω_ἀπειλέω_ἀπειλέω2_
νέες	verb_noun_verb_verb_verb_	νέω3_ναῦς_νέω2_νέω_νέω1_
ὤθει	verb_verb_	ὀθέω_ὠθέω_
δῆσαι	verb_verb_verb_	δέομαι_δέω1_δέω2_
ξανθῶ	verb_verb_adjective_	ξανθόω_ξαίνω_ξανθός_
βουλευταῖς	adjective_noun_	βουλευτός_βουλευτής_
ὑμεναίους	noun_verb_	ὑμέναιος_ὑμεναιόω_
ἥρωα	noun_noun_	ἥρως_ἥρως_
ἔλαθεν	verb_verb_	λανθάνω_ἐλαύνω_
μικρῶ	adjective_adjective_	μικρός_σμικρός_
Τυρὼ	noun_noun_	τυρός_Τυρώ_
Μαχάων	noun_noun_	μάχη_Μαχάων_
οὐρίων	noun_adjective_verb_noun_verb_	οὔριον_οὔριος_οὐριόω_ὄρος_οὐρέω_
μορίου	noun_adjective_	μόριον_μόριος_
οἴην	noun_verb_adjective_	οἴη_οἰάω_οἶος_
ζυγῶ	noun_verb_verb_verb_noun_	ζυγός_ζεύγνυμι_ζυγόω_ζυγέω_ζυγόν_
ἔλασσον	verb_adjective_	ἐλαύνω_ἐλάσσων_
Ἀσίω	adjective_verb_adjective_noun_	ἄσιος_ἄω3_Ἄσιος_Ἀσίας_
ἴωμεν	verb_verb_	εἰμί_εἶμι_
κνίσης	verb_noun_	κνισάω_κνῖσα_
νοῦ	verb_verb_verb_verb_verb_noun_	νέω1_νέομαι_νέω̄_νέω_νέω3_νόος_
ῥηθὲν	verb_verb_	ἐρῶ_ῥέομαι_
κυνῶν	noun_verb_verb_noun_	κύων_κυνάω_κυνέω_κυνώ_
βρόγχον	noun_noun_	βρόγκος_βρόγχος_
ὁρμῶσι	verb_verb_	ὁρμέω_ὁρμάω_
αἰκιζόμενος	verb_verb_	αἰκίζω_αἰκίζομαι_
ἄρθρω	verb_noun_	ἀρθρόω_ἄρθρον_
Ῥήσω	noun_verb_	Ῥῆσος_ῥέομαι_
λύπης	noun_verb_	λύπη_λυπέω_
Ἀρίσταρχός	noun_noun_	Ἀρίσταρχος_ἀρίσταρχος_
κονίῃσιν	adjective_verb_noun_	κόνιος_κονίω_κονία_
συγκλείσῃ	noun_verb_	σύγκλεισις_συγκλείω_
μυρίων	adjective_verb_	μυρίος_μύρω_
σὴν	noun_adjective_	σής_σός_
ἡδονῶν	noun_noun_	ἡδονή_ἡδονά_
νεωτέρου	adjective_adjective_	νέος_νεώτερος_
ἀκονῶν	verb_noun_	ἀκονάω_ἀκόνη_
ὄφειλον	verb_verb_	ὀφείλω_ὀφέλλω_
Δώριον	adjective_verb_	Δώριος_δωρέω_
ἀναπλεῦσαι	verb_verb_	ἀναπλόω_ἀναπλέω_
ἀνιᾶται	verb_verb_verb_	ἀνιάζω_ἀνιάομαι_ἀνιάω_
οἴνῳ	noun_noun_	οἶνος_οἶνον_
ἐρᾷ	verb_verb_verb_	ἐράομαι_ἐράω2_ἐράω1_
Φρυγίην	adjective_adjective_noun_noun_	Φρύγιος_φρύγιος_φρυγία_Φρυγία_
μῦρον	verb_noun_	μύρω_μῦρος_
χρῶ	verb_verb_verb_verb_	χράω1_χραύω_χράομαι_χράω2_
δωρεῖται	verb_verb_	δωρέομαι_δωρέω_
Διονυσίῳ	adjective_noun_	Διονύσιος_Διονύσιον_
προλέγεται	verb_verb_	προλέγω1_προλέγω2_
ἀνατολὰς	adverb_noun_	ἀνατολάς_ἀνατολή_
ἡμέραν	noun_adjective_	ἡμέρα_ἥμερος_
δειλίαν	verb_noun_	δειλιάω_δειλία_
προέμεν	verb_verb_	πρόειμι2_προίημι_
σεῖο	verb_pronoun_	σέω_σύ_
ἐπιμάσσεται	verb_verb_	ἐπιμάσσομαι_ἐπιμαίομαι_
σκηνῇ	verb_noun_verb_	σκηνάω_σκηνή_σκηνέω_
φυλακῶν	noun_noun_	φυλακή_φυλακός_
νεκροῖς	verb_adjective_	νεκρόω_νεκρός_
ἀνιᾶσθαι	verb_verb_verb_	ἀνιάομαι_ἀνιάζω_ἀνιάω_
τελέουσι	verb_verb_	τέλλω_τελέω_
νευραὶ	noun_noun_	νευρά_νευρή_
στέγην	noun_noun_verb_	στέγος_στέγη_στέγω_
φάγοι	adjective_verb_	φάγος_ἐσθίω_
φυλασσομένοισι	verb_verb_	φυλάσσω_φυλάζω_
μαντευόμενον	verb_verb_	μαντεύω_μαντεύομαι_
ἠθικός	adjective_verb_	ἠθικός_ἐθίζω_
δύνασαι	verb_verb_	δύω2_δύναμαι_
σφαλμοῦ	noun_verb_verb_	σφαλμός_σφαλμάω_σφαλμέω_
γέντο	verb_verb_	γίγνομαι_γέντο_
λάμφ'	noun_verb_	λάμπη_λάμπω_
Ἀθηναίοις	adjective_noun_noun_noun_	Ἀθηναῖος_Ἀθήναια_Ἀθήναιος_Ἀθήναιον_
Ἕκτορα	noun_noun_	Ἕκτωρ_ἕκτωρ_
τῷ	adverb_article_irregular_pronoun_	τῷ_ὁ_τίς_τις_
ἥσυχα	adverb_adjective_	ἥσυχα_ἥσυχος_
Κρήτην	noun_noun_	κρήτη_Κρήτη_
καθαρῶ	adjective_verb_	καθαρός_καθαίρω_
πυρᾷ	verb_noun_	πυράζω_πυρή_
ἄγεθ'	adverb_verb_	ἄγε_ἄγω_
Ἐφύρην	noun_verb_	Ἐφύρα_φυράω_
ἐκτομὰς	noun_noun_	ἐκτομάς_ἐκτομή_
στίχω	noun_verb_	στίχος_στείχω_
αἰκίσασθαι	verb_verb_	αἰκίζομαι_αἰκίζω_
φίλην	adjective_noun_	φίλος_φῖλος_
χάζετ'	verb_verb_	χάζω_χάζομαι_
εἴριον	noun_verb_	ἔριον_εἰρέω_
λισσομένη	verb_verb_	λίσσομαι_λίζω_
ἐκτήσατο	verb_verb_	κτάομαι_κτέομαι_
ἄποινα	adjective_noun_	ἄποινος_ἄποινα_
ξυροῦ	noun_noun_verb_verb_	ξυρόν_ξυρός_ξυρέω_ξυράω_
βροντῆς	verb_verb_noun_	βροντάζω_βροντάω_βροντή_
ἱρή	adjective_adjective_	ἱερός_ἱρός_
ἅπερ	article_pronoun_	ὁ_ὅς_
ἐπισσώτροις	noun_noun_	ἐπίσωτρον_ἐπίσσωτρον_
Ὕπνου	noun_noun_verb_noun_	ὕπνον_ὕπνος_ὑπνόω_Ὕπνος_
δίεσθαι	verb_verb_	δίω_δίεμαι_
κτάμεναι	verb_verb_	κτάομαι_κτείνω_
ἀπόβλητ᾽	adjective_verb_	ἀπόβλητος_ἀποβάλλω_
χρωμένους	verb_verb_verb_verb_	χράω1_χράω2_χράομαι_χραύω_
ῥύσι	noun_noun_	ῥύσις_ῥῦσις_
Φοίνικι	noun_noun_	Φοῖνιξ_φοῖνιξ_
ποιητὴν	adjective_noun_	ποιητός_ποιητής_
θυμῶ	verb_noun_	θυμόω_θυμός_
μοίρα	noun_verb_	μοῖρα_μοιράω_
πανταχόσε	adverb_adverb_adverb_adverb_	πανταχοῖ_πανταχόσε_πανταχοῦ_πανταχῶς_
χέρνιβα	noun_noun_	χέρνιβον_χέρνιψ_
ἐχρῶντο	verb_verb_verb_verb_	χράομαι_χράω1_χραύω_χράω2_
ἐφύλαξαν	verb_verb_	φυλάζω_φυλάσσω_
ῥοάων	noun_noun_	ῥόα_ῥοή_
πεφρίκασι	verb_verb_	φρίζω_φρίσσω_
μήνας	verb_noun_	μαίνομαι_μήνη_
πόλεων	noun_adjective_noun_	πόόλις_πολύς_πόλις_
οἱ	pronoun_article_	ἕ_ὁ_
χαλκοῦ	noun_adjective_verb_	χαλκοῦς_χάλκεος_χαλκόω_
φλέω	noun_verb_noun_	φλέως_φλέω_φλέος_
εὐθεῖαν	adjective_noun_	εὐθύς1_εὐθεῖα_
περιῶν	verb_verb_verb_	περί-ἱέω_περί-ἰόω_περί-ἰάζω_
προσδῶμεν	verb_verb_	προσδίδωμι_προσδέω_
παρόρμησιν	noun_verb_	παρόρμησις_παρορμάω_
Πέργαμον	noun_noun_	Πέργαμος_Πέργαμον_
σωμάτων	verb_noun_	σωματόω_σῶμα_
πεδίῳ	noun_noun_	πέδιον_πεδίον_
κοινῶς	adjective_verb_	κοινός_κοινόω_
παραδέξασθαι	verb_verb_	παραδείκνυμι_παραδέχομαι_
κατέχεεν	verb_verb_	καταχέω_κατέχω_
ποίαν	adjective_noun_	ποῖος_πόα_
περίεσαν	verb_verb_	περίειμι1_περιέννυμι_
ἄρ'	verb_noun_verb_particle_	ἀρόω_ἄρον_αἴρω_ἄρα_
λείας	noun_adjective_	λεία_λεῖος_
κρείττων	verb_adjective_	κρεισσόω_κρείσσων_
πέτρου	noun_verb_	πέτρος_πετρόω_
νοοῦντες	verb_verb_	νοόω_νοέω_
κανὼν	noun_verb_	κανών_καίνω_
νέομαι	verb_verb_verb_	νέομαι_νέω_νέω3_
ἴσω	verb_adjective_	ἰσόω_ἴσος_
μήνι'	noun_noun_verb_	μῆνις_μήνιον_μηνίω_
πιθώμεθα	verb_verb_verb_	πείθω_πιθόω_πιθέω_
Βοιωτία	noun_adjective_	Βοιωτία_Βοιώτιος_
ἀκοστήσας	verb_verb_	ἀκοστέω_ἀκοστάω_
δίωνται	verb_verb_verb_	διίημι_δίω_δέομαι_
σκύλα	noun_verb_	σκύλος_σκυλάω_
τὲ	pronoun_particle_	σύ_τε_
ἐξέχει	verb_verb_	ἐκχέω_ἐξέχω_
σπάρτα	noun_noun_adjective_	σπάρτον_σπάρτη_σπαρτός_
πτύελον	noun_noun_	πτύελον_πτύελος_
ἐπίκλησιν	verb_noun_	ἐπικλάω_ἐπίκλησις_
Θρᾳκῶν	noun_noun_	Θρᾷξ_Θρᾳκία_
ζυγοὺς	noun_noun_	ζυγόν_ζυγός_
πέρας	noun_noun_verb_verb_	πέρα_πέρας_περάω1_περάω2_
πεπονημένα	verb_verb_	πονέομαι_πονέω_
ποτῶνται	verb_verb_	ποτάομαι_ποτέομαι_
σταθμῶ	noun_verb_noun_verb_verb_	σταθμός_σταθμάω_σταθμόν_σταθμάομαι_σταθμόω_
ζώων	verb_verb_	ζώω_ζάω_
ἄκρα	noun_adjective_noun_	ἄκρα_ἄκρος_ἄκρον_
ἐπείπερ	conjunction_conjunction_	ἐπείπερ_ἐπεί_
ζυγὸς	noun_noun_	ζυγόν_ζυγός_
ἀπήχθετο	verb_verb_verb_	ἀπάχθομαι_ἀπέχθομαι_ἀπεχθάνομαι_
κρυπτῇ	noun_adjective_	κρυπτή_κρυπτός_
εἰκός	verb_verb_	ἔοικα_εἰκός_
νείκεε	verb_noun_noun_	νεικέω_νεῖκος_νει_
ἴ̈διον	verb_verb_adjective_	ἰδέω_ἰδίω_ἴδιος_
ἀθροίσας	verb_verb_	ἀθροίζω_ἀθρέω_
Ἀθήνας	noun_noun_noun_	Ἀθήνευς_Ἀθήνη_Ἀθῆναι_
Ἰλίου	adjective_adjective_noun_noun_	Ἴλι_Ἴλιοσλιος_Ἴλιον_Ἴλιος_
κτύπον	verb_noun_	κτυπέω_κτύπος_
δύσει	verb_noun_verb_	δύω2_δύσις_δύω1_
ἀπέχει	verb_verb_	ἀποχέω_ἀπέχω_
λίσσεσθ'	verb_verb_	λίζω_λίσσομαι_
ποικίλως	verb_adjective_	ποικιλόω_ποικίλος_
ὄμβρος	noun_noun_	ὄμβρος_ὄμβρος_
Ὑρία	noun_noun_	Ὑρίευς_Ὑρίη_
ἐκείνους	verb_pronoun_	κενόω_ἐκεῖνος_
γῆς	noun_noun_	γῆ_Γαῖα_
Μαίας	noun_noun_adjective_	Μαῖα_μαῖα_Μάιος_
συκῆς	noun_verb_	συκῆ_συκάζω_
ἄκεσιν	noun_noun_	ἄκος_ἄκεσις_
ἐπορεύθη	verb_verb_	ἐφορεύω_πορεύω_
Τελαμών	noun_noun_	τελαμών_Τελαμών_
καλῇ	verb_adjective_	καλέω_καλός_
λάχῃσιν	verb_noun_	λαγχάνω_λάχη_
ἑστᾶσ'	verb_verb_	ἵ_ἵστημι_
βάρη	verb_noun_noun_	βαρέω_βάρος_βᾶρις_
φορᾶς	noun_noun_	φορά_φορεύς_
ἀγάσσασθαι	verb_verb_	ἄγαμαι_ἀγάζω_
ἔσθ'	verb_verb_conjunction_	ἔσθω_εἰμί_ἔστε_
ἀριστεῖς	noun_verb_	ἀριστεύς_ἀριστάω_
δεξιαὶ	noun_adjective_	δεξιά_δεξιός_
ὅρκια	noun_adjective_	ὅρκιον_ὅρκιος_
περόνης	verb_noun_	περονάω_περόνη_
ἱρήν	adjective_adjective_	ἱρός_ἱερός_
ἀνδρείᾳ	adjective_noun_	ἀνδρεῖος_ἀνδρεία_
ἐλέχθη	verb_verb_	λέγω2_λέγω3_
ζῶντι	verb_verb_	ζέω_ζάω_
ἐρωμένων	verb_noun_verb_verb_	ἐράω2_ἐρώμενος_ἐράομαι_ἐράω1_
θεῖος	noun_adjective_	θεῖος2_θεῖος1_
ἐσθιόμενον	verb_verb_	εἰσθέω_ἐσθίω_
δερμάτων	verb_noun_	δερματόω_δέρμα_
πολεμοῦ	verb_verb_	πολεμόω_πολεμέω_
δαὶ	noun_particle_	δαίς1_δαί_
γεννήσεις	verb_noun_	γεννάω_γέννησις_
ἴ̈σαν	adjective_verb_verb_	ἴσος_οἶδα_εἶμι_
μάχῃ	noun_verb_	μάχη_μάχομαι_
διαστῇ	verb_verb_	διίστημι_διαστάζω_
Ἐφύρα	verb_noun_noun_	φυράω_Ἐφύρα_Ἔφυρα_
ζυγός	noun_noun_	ζυγόν_ζυγός_
πατρί	noun_noun_	πατρίς_πατήρ_
Φαίαξιν	noun_noun_	φαίαξ_Φαίαξ_
σπουδῆς	verb_noun_	σπουδάζω_σπουδή_
προσφιλεῖς	adjective_verb_	προσφιλής_προσφιλέω_
μάστιε	noun_verb_	μάστις_μαστίω_
λέγεται	verb_verb_verb_	λέγω2_λέγω3_λέγω1_
κάρη	verb_noun_	κείρω_κάρα_
βεβολημένος	verb_verb_verb_	βεβόλημαι_βολέω_ἀντιβολέω_
ἀδελφῶν	noun_noun_	ἀδελφή_ἀδελφός_
Καρῶν	noun_verb_noun_noun_noun_noun_	κάρα_καρόω_Κάραι_Κάρ_κάρ_καρώ_
Περσεφόνην	noun_noun_	Φερσέφασσα_Περσεφόνη_
Ἀριστάρχου	noun_noun_	ἀρίσταρχος_Ἀρίσταρχος_
ἴ̈σκε	verb_verb_	ἴσκω_ἴσκε_
ποιουμένους	verb_verb_	ποιόω_ποιέω_
υἱοί	noun_verb_	υἱός_υἱόω_
ἥφθη	verb_verb_	ἕπομαι_ἅπτω_
Σινωπικῇ	noun_adjective_	Σινωπική_Σινωπικός_
ἰδεῖν	verb_verb_	εἶδον_ἰδέω_
τάφον	verb_noun_	τέθηπα_τάφος1_
σπορᾶς	verb_noun_noun_	σποράζω_σπορεύς_σπορά_
διόλου	adverb_verb_	διόλου_διόλλυμι_
συνδήσῃ	verb_verb_	συνδέομαι_συνδέω_
βλάβην	verb_noun_noun_	βλάπτω_βλάβος_βλάβη_
θέρμη	noun_noun_	θέρμη_θέρμα_
Δάφνη	noun_noun_	δάφνη_Δάφνη_
Μυσίαν	adjective_verb_noun_	Μύσιος_μυσιάω_μυσία_
Ὅμηρoν	noun_noun_	ὅμηρος_Ὅμηρος_
μαντεῖον	noun_adjective_	μαντεῖον_μαντεῖος_
πτήσει	verb_noun_	πέτομαι_πτῆσις_
ἀπόκρισιν	noun_noun_	ἀπόκρισις_ἄποκρισλς_
δύσω	verb_verb_	δύω2_δύω1_
γηράσας	verb_verb_verb_	γηράω_γηράσκω_γηοριξ_
ἧσπερ	pronoun_noun_	ὅς_εἷς_
ὀδόντας	noun_noun_	ὀδών_ὀδούς_
παρ'	adjective_preposition_	πηρός_παρά_
πείσεις	verb_noun_	πείθω_πεῖσις_
Κισσέας	noun_noun_	Κισσεύς_Κισσῆς_
δούλους	verb_adjective_	δουλόω_δοῦλος_
συμβόλῳ	noun_noun_	σύμβολος_σύμβολον_
τειχίον	verb_noun_	τειχέω_τειχίον_
Πηλείωνος	noun_noun_	Πηλεύς_Πηλείων_
στίχου	verb_noun_	στείχω_στίχος_
μαχήσασθαι	verb_verb_verb_	μάχομαι_μαχάω_συμμαχέω_
ἒν	preposition_preposition_verb_	εἰς_ἐν_εἰμί_
ξεῖνος	noun_adjective_	ξένος1_ξένος2_
μήνιε	verb_noun_	μηνίω_μῆνις_
ἡττηθέντα	verb_verb_	ἡττάω_ἡσσάομαι_
κυλίνδει	verb_verb_	κυλινδέω_κυλίνδω_
λιγέως	adjective_adverb_	λιγύς_λιγέως_
Μακεδονία	noun_adjective_	Μακεδονία_Μακεδ́νιος_
Ἰ¨φιγένειαν	noun_noun_noun_	Ἰφίγενεια_Ἰφιγένεια_Ἰφιγενεία_
νέονται	verb_verb_verb_	νέω3_νέομαι_νέω_
κεκριμένως	verb_adverb_	κρίνω_κεκριμένως_
ῥεῖ	verb_verb_	ῥέω_ῥέομαι_
ἐνετῇσι	adjective_noun_	ἐνετός_ἐνετή_
διήκουσαι	verb_verb_	διήκω_διακούω_
οὕ	pronoun_exclamation_	ἕ_ἒ_
συνδέον	verb_verb_	συνδέω_συνδέομαι_
ἀνάξει	verb_noun_verb_verb_verb_	ἀνάγω_ἄναξις_ἀνάσσω_ἀναξέω_ἀνάζω_
ἄξων	noun_noun_verb_verb_	ἄξων_ἄξος_ἄγνυμι_ἄγω_
ἱππόμαχοι	adjective_adjective_	ἱππομάχος_ἱππόμαχος_
πήγνυσι	verb_noun_	πήγνυμι_πήγνυσις_
βίη	verb_noun_	βιάω_βία_
δεύει	verb_verb_verb_	δέω2_δεύομαι_δεύω2_
ὥρα	verb_noun_	ὁράω_ὥρα_
Χαλκώδοντος	noun_noun_	χαλκώδων_Χαλκώδων_
ἀντίθεον	verb_verb_adjective_	ἀντιθέω_ἀνατίθημι_ἀντίθεος_
ἱεροῦ	verb_adjective_verb_	ἱερόω_ἱερός_ἱεράομαι_
ὁμοκλήσειεν	verb_verb_	ὁμοκλέω_ὁμοκλάω_
οὐλόμεν'	adjective_noun_	οὐλόμενος_οὐλόμενον_
ἔλασσεν	verb_verb_	ἐλαύνω_λάζω_
Παλαίφατος	adjective_noun_	παλαίφατος_Παλαίφατος_
καυτὸς	adjective_adjective_	καυστός_καυτός_
δηΐων	verb_adjective_	δηιόω_δάιος_
φυτόν	adjective_noun_	φυτός_φυτόν_
δηΐου	verb_adjective_	δηιόω_δάιος_
βάρους	noun_noun_	βᾶρος_βάρος_
θύεσθαι	verb_verb_	θύω2_θύω1_
δεσμῶν	verb_verb_verb_verb_noun_noun_	δεσσμέω_δεσμεύω_δεσμέω_δεσεύω_δεσμός_δέσμη_
ἔπιόν	verb_noun_	πίνω_ἔπιον_
Ἀρίσταρχον	noun_noun_	ἀρίσταρχος_Ἀρίσταρχος_
Λαομέδοντα	noun_noun_	λαομέδων_Λαομέδων_
ἔα	exclamation_verb_verb_	ἔα_ἐάω_εἰμί_
ἥρως	noun_noun_	ἥρως_ἥρως_
ἴ̈σας	adjective_verb_	ἴσος_οἶδα_
ἐλάττων	adjective_verb_	ἐλάσσων_ἐλασσόω_
προδιασυνίστησιν	διά-συνιστά_διά-συνίστημ_	πρό_πρό_
μάλα	adverb_noun_	μάλα_μάλη_
ἐλλείψει	verb_noun_	ἐλλείπω_ἔλλειψις_
ἰάσονται	verb_verb_	ἰάομαι_ἰάζω_
μαιμώωσα	verb_verb_	μαιμάω_μαιμάζω_
Φύλακον	noun_noun_	φυλακός_Φύλακος_
τηρητέον	adjective_adjective_	τηρητέον_τηρητέος_
πολυπίδακος	noun_adjective_	πολυπῖδαξ_πολυπίδακος_
πολεμητέον	adjective_adjective_	πολεμητέον_πολεμητέος_
τροχῶν	noun_verb_noun_	τροχή_τροχάζω_τροχός_
Φωκίδος	noun_noun_	Φωκίς_φωκίς_
Φοῖβος	adjective_noun_	φοῖβος_Φοῖβος_
Ὅμηρός	noun_noun_	ὅμηρος_Ὅμηρος_
ἴδηται	verb_verb_	εἶδον_ἰδέω_
πατρὶ	noun_noun_	πατρίς_πατήρ_
ἀρσενικῷ	noun_adjective_	ἀρσενικόν_ἀρσενικός_
γηράσει	verb_verb_	γηράσκω_γηράω_
Δαναοῖσιν	noun_noun_	Δαναός_Δαναοί_
λεγόμενον	verb_verb_verb_	λέγω1_λέγω3_λέγω2_
βραβευτής	noun_noun_	βραβευτής_βραβεύς_
ἀγέμεν	verb_verb_	ἄγω_ἄγνυμι_
ὀσφρήσει	noun_verb_	ὄσφρησις_ὀσφραίνομαι_
νέουσι	verb_verb_verb_verb_	νέω3_νέω2_νέω_νέω1_
πρόσφατον	verb_adjective_	πρόσφημι_πρόσφατος_
ἐλέλιξεν	verb_verb_	ἐλελίζω2_ἐλελίζω1_
Κῆρυξ	noun_noun_	κῆρυξ_Κήρυξ_
εἰρήσεται	verb_verb_verb_	ἔρομαι_εἰρέω_ἐρῶ_
πείσεται	verb_verb_	πείθω_πάσχω_
τί	pronoun_irregular_	τις_τίς_
οὔτ'	pronoun_adverb_adverb_	οὔτις_οὔτε_οὔτι_
Ἄρες	noun_verb_	Ἄρης_αἴρω_
θείη	verb_adjective_noun_	τίθημι_θεῖος1_θεία_
Ἀπολλώνιον	noun_adjective_	Ἀπολλώνιον_Ἀπολλώνιος_
σέλας	noun_verb_	σέλας_σελάω_
δειλοί	verb_adjective_	δειλόομαι_δειλός_
νέεσθαι	verb_verb_verb_	νέω3_νέω_νέομαι_
ὕπνους	verb_noun_	ὑπνόω_ὕπνος_
σταθμοῖο	verb_verb_noun_noun_verb_	σταθμόω_σταθμόομαι_σταθμόν_σταθμός_σταθμάομαι_
τάχα	adjective_adverb_noun_	ταχύς_τάχα_τάχος_
ματαίου	adjective_verb_	μάταιος_ματαιόω_
εἰλεῦντο	verb_verb_	εἰλέω_εἴλω_
θοὰς	noun_adjective_	θοάς_θοός_
ὅρκου	verb_noun_	ὁρκόω_ὅρκος_
φῶτ'	noun_noun_	φώς_φάος_
ἀπίης	verb_adjective_	ἀφίημι_ἄπιος2_
κόπρον	noun_noun_	κόπρος_κόπρον_
βαλάνων	noun_verb_	βάλανος_βαλανόω_
τεύξει	verb_noun_verb_	τυγχάνω_τεῦξις_τεύχω_
Φωκήων	noun_noun_	Φωκεύς_φωκεύς_
ἴδιος	adjective_noun_	ἴδιος_ἶδος_
μοίραν	verb_noun_	μοιράω_μοῖρα_
ἧκε	verb_verb_	ἵημι_ἥκω_
νεὼς	noun_noun_noun_	νεώς_ναῦς_ναός_
Διοσκούροις	noun_noun_	Διόσκοροι_Διόσκουροι_
Κρητῶν	noun_noun_noun_	Κρήτη_κρήτη_Κρής_
ἡγήσατ'	verb_verb_	ἡγέομαι_ἁγέομαι_
ἆρα	verb_noun_	αἴρω_ἆρα_
κεῖτ᾽	verb_verb_	κέω_κεῖμαι_
εἰδὼς	verb_noun_	οἶδα_εἰδοί_
μάθῃ	verb_noun_	μανθάνω_μάθη_
ἧσ'	verb_verb_verb_verb_noun_	ἥδομαι_ἧμαι_κάθημαι_ἵημι_ἧσις_
ἐκβολῆς	noun_noun_	ἐκβολεύς_ἐκβολή_
Ὑπερήνορος	noun_noun_	ὑπερήνωρ_Ὑπερήνωρ_
Πυρῆς	noun_verb_noun_	πυρεύς_πυράζω_πυρή_
ἐμέο	verb_pronoun_	ἐμέω_ἐγώ_
ἐνέδησα	verb_verb_	ἐνδέω1_ἐνδέω2_
χειμάρρους	adjective_adjective_	χειμάρρους_χείμαρρος_
ἐπιστάσθω	verb_verb_	ἐπίσταμαι_ἐφίστημι_
πόσεως	noun_noun_	πόσις1_πόσις2_
ὤρη	verb_noun_noun_	ὠρέω_ὤρα_ὦρος_
Φωκεῖς	noun_noun_	Φωκεύς_φωκεύς_
Γλαῦκον	noun_noun_noun_	Γλαῦκος_γλαῦκος_Γλαύκος_
τόλμα	verb_noun_	τολμάω_τόλμα_
ἀπειλῇ	noun_verb_verb_verb_	ἀπειλή_ἀπειλέω1_ἀπειλέω2_ἀπειλέω_
νυμφίοι	adjective_noun_	νυμφίος2_νυμφίος1_
ἀντιγράφων	verb_adjective_	ἀντιγράφω_ἀντίγραφος_
πασιμέλουσα	adjective_noun_	πασιμέλων_πασιμέλουσα_
Γῇ	noun_noun_	γῆ_Γαῖα_
Ἑλένης	noun_noun_	Ἑλένη_ἑλένη_
δείξῃ	noun_verb_noun_	δείξις_δείκνυμι_δεῖξις_
ἀεκήλια	adjective_adjective_	ἀεικής_ἀεκήλιος_
δέξασθαι	verb_verb_	δείκνυμι_δέχομαι_
ξύσει	verb_noun_	ξύω_ξῦσις_
ἀνδρείας	adjective_noun_	ἀνδρεῖος_ἀνδρεία_
ἀπειλήσω	verb_verb_verb_	ἀπειλέω1_ἀπειλέω2_ἀπειλέω_
νοήσει	verb_noun_	νοέω_νόησις_
ἔπεσ'	noun_verb_verb_verb_verb_	ἔπος_πίπτω_ἐφέζομαι_ἐφίημι_ἐπιέννυμι_
πόλις	noun_noun_	πόλις_πόόλις_
ὑστατίῃσι	adjective_noun_	ὑστάτιος_ὑστατίη_
ἐπιταγῇ	noun_verb_	ἐπιταγή_ἐπιτάσσω_
αἲ	conjunction_exclamation_	εἰ_αἴ_
βεβολήατο	verb_verb_verb_	βολέω_βεβόλημαι_ἀντιβολέω_
κακοῦ	verb_adjective_	κακόω_κακός_
οἷο	pronoun_verb_	ὅς_ἵημι_
Ὀδυσσεία	noun_adjective_	Ὀδύσσεια_Ὀδύσσειος_
Ἐχινάδων	noun_noun_	Ἐχῖναι_Ἐχινάδες_
θαυμαστοῦ	adjective_verb_noun_	θαυμαστός_θαυμαστόω_θαυμαστής_
τριχώσεις	verb_verb_noun_	τριχόομαι_τριχόω_τρίχωσις_
Δαυλιέως	noun_noun_	Δαύλιος_Δαυλιεύς_
πλευρά	noun_noun_	πλευρά_πλευρόν_
δαφοινεόν	adjective_adjective_	δαφοινεός_δαφοινός_
ἄξετε	verb_verb_verb_	ἄγω_ἄγνἄγνυμι_ἄγνυμι_
κεῖντο	verb_verb_	κεῖμαι_κέω_
ἠνορέη	noun_noun_	ἠνορέα_ἠνορέη_
πεῖρα	verb_noun_	πείρω_πεῖρα_
ἀλκῆς	noun_verb_	ἀλκή_ἀλκάζω_
ἥρωος	noun_noun_	ἥρως_ἥρως_
τίνος	pronoun_irregular_	τις_τίς_
Ἰνοῖ	verb_verb_verb_noun_	ἰνόω_ἰνέω_ἰνάω_Ἰνώ_
συμποσίῳ	adjective_noun_	συμπόσιος_συμπόσιον_
αὖθ'	adverb_adverb_	αὖτε_αὖθι_
κρείων	noun_noun_	κρεῖον_κρείων_
Πάτροκλον	noun_noun_	Πάτροκλος_Πατρόκλον_
Θετταλίας	noun_noun_	Θεσσαλίη_Θεσσαλία_
κηρός	noun_noun_	κηρός_κήρ_
ἠξίου	verb_verb_	ἀξιόω_ἐξιόω_
ἐδάμασε	verb_verb_	δαμάω_δαμάζω_
εἶπε	noun_verb_	εἶπος_εἶπον_
θυμιάσαι	verb_verb_	θυμιάζω_θυμιάω_
ἔλαιον	noun_noun_	ἔλαιον_ἔλαιος_
κάτωθεν	verb_adverb_	κατόω_κάτωθεν_
ἔπειθ'	verb_verb_adverb_	πείθω_ἔπειμι2_ἔπειτα_
ἐπικλᾶται	verb_verb_	ἐπικλάζω_ἐπικλάω_
ὑψῶν	noun_verb_	ὕψος_ὑψόω_
πολύτλας	noun_noun_	πόλυτλας_πολύτλας_
Γοργοῦς	noun_noun_	Γόργω_Γοργώ_
παλαιοί	verb_adjective_	παλαιόω_παλαιός_
δι'	conjunction_preposition_	διό_διά_
παρθενίαν	noun_adjective_noun_	παρθενία_παρθένιος_παρθενίης_
δεινῶς	verb_adjective_	δεινόω_δεινός_
οἵ	pronoun_article_pronoun_	ὅς_ὁ_ἕ_
στέρησιν	verb_noun_	στέρομαι_στέρησις_
νοουμένου	verb_verb_	νοέω_νοόω_
ἐμπόριον	noun_noun_	ἐμπόριον_ἐμπόριος_
Αἰτωλίαν	adjective_noun_noun_	Αἰτώλιος_Αἰτωλία_Αἰτωλίη_
δήσαντε	verb_verb_	δέω1_δέω2_
νέα	verb_noun_noun_adjective_	νεάω_νέα_ναῦς_νέος_
θερισταί	adjective_noun_	θεριστός_θεριστής_
ἔφθασαν	verb_verb_	φθάνω_φθάζω_
γένεσιν	noun_noun_	γένος_γένεσις_
πόρε	verb_noun_	πόρω_πόρος_
παριστᾶσιν	verb_verb_	παρίστημι_παριστάω_
Ἄρεος	noun_adjective_noun_noun_noun_	Ἄρευς_Ἄρεος_ἄρος_Ἄρις_Ἄρης_
ὑπερώϊον	noun_verb_	ὑπερῷον_ὑπερωέω_
ἄκυρον	noun_adjective_	ἄκυρον_ἄκυρος_
μικρὸν	adjective_adjective_	μικρός_σμικρός_
ἀνδρῶν	noun_verb_	ἀνήρ_ἀνδρόω_
ἐΐσας	adjective_adjective_	ἴσος_ἔισος_
Ἕλλην	noun_noun_	Ἕλλην_Ἕλλη_
ἁπλοῦν	adjective_verb_	ἁπλόος_ἁπλόω_
Κῆϋξ	noun_noun_noun_	Κῆϋξ_Κήϋξ_κήυξ_
δέῃ	verb_verb_verb_verb_	δέομαι_δέω2_δέω1_δεῖ_
ἐνθουσιῶσα	verb_verb_	ἐνθουσιάω_ἐνθουσιάζω_
λεγόμενον	verb_verb_verb_	λέγω2_λέγω3_λέγω1_
φωτὸς	noun_noun_	φώς_φάος_
Ἀλεξάνδρου	noun_adjective_	Ἀλέξανδρος_ἀλέξανδρος_
λέγουσι	verb_verb_verb_	λέγω1_λέγω2_λέγω3_
τείχη	verb_noun_	τειχέω_τεῖχος_
πολεμῶν	verb_verb_	πολεμόω_πολεμέω_
ἰστὲον	adjective_adjective_	ἰστέος_ἰστέον_
αἰτίαν	noun_adjective_	αἰτία_αἴτιος_
οὐλῶν	noun_noun_verb_	οὐλαί_οὐλή_οὐλέω_
ξένη	adjective_noun_	ξένος2_ξένη_
κεχαρισμένον	verb_verb_	χαρίζομαι_χαρίζω_
ὀρθοῦ	verb_adjective_	ὀρθόω_ὀρθός_
ἥψατο	verb_verb_	ἅπτω_ἑψάω_
πάσσω	adjective_noun_verb_noun_verb_	πάσσων_πάσσον_πάσσω_πάσσος_πατέομαι_
κλίνης	verb_noun_	κλίνω_κλίνη_
λάχῃσι	verb_noun_	λαγχάνω_λάχη_
λάζετο	verb_verb_	λάζω_λάζομαι_
φανήσεσθαι	verb_verb_	φαίνω_φανάω_
θείοίο	verb_adjective_noun_verb_	θεάομαι_θεῖος1_θεῖος2_θεάω_
Κῶ	verb_noun_particle_	κέω_Κῶς_πω_
Πύλω	noun_noun_noun_verb_	Πύλος_Πύλης_πύλος_πυλόω_
κέλεαί	verb_verb_	κέλλω_κέλομαι_
ὄφειλεν	verb_verb_	ὀφέλλω_ὀφείλω_
Ἡρακλέα	noun_noun_	Ἡράκλεα_Ἡρακλῆς_
ἐπικατήφθη	κατά-ἀφθά_κατά-ἕπομα_verb_	ἐπί_ἐπί_ἐπί-καθάπτω_
Λάμπον	verb_noun_	λάμπω_Λάμπος_
ζυγόν	noun_noun_	ζυγόν_ζυγός_
δεσμοῦ	verb_noun_verb_	δεσμεύω_δεσμός_δεσμέω_
Πυθὼν	noun_verb_	Πυθών_πυνθάνομαι_
πυθοίατο	verb_verb_	πύθω_πυνθάνομαι_
οὐτάμεναι	verb_verb_	οὐτάω_οὐτάζω_
παρὰ	preposition_adjective_	παρά_πηρός_
τίσουσιν	verb_verb_verb_	τίνω_τίζω_τίω_
αἰνισσόμενον	verb_verb_verb_	αἰνίσσομαι_αἰνίζω_αἰνίζομαι_
λάπαθον	noun_noun_	λάπαθον_λάπαθος_
ἀχέων	verb_noun_verb_verb_noun_	ἠχέω_ἄχος_ἀχεύω_ἀχέω2_ἠχή_
λέγεσθαι	verb_verb_verb_	λέγω2_λέγω1_λέγω3_
σκολιῶν	adjective_verb_	σκολιός_σκολιάζω_
πλείω	verb_adjective_adjective_adjective_	πλέω_πλείωνίων_πλέως_πλείων_
Βορέου	noun_noun_	Βορέας_Βορέης_
περιστῇ	verb_verb_verb_	περιστάζω_περιστάζομαι_περιίστημι_
Ζῆν'	noun_adjective_	Ζεύς_ζῆνος_
Ἱπποκράτης	noun_verb_noun_	Ἱπποκράτης_ἱπποκρατέω_Ἱπποκράτη_
χάρμη	noun_noun_	χάρμης_χάρμη_
δικαίως	adjective_verb_	δίκαιος_δικαιόω_
κατεπλάγη	verb_verb_	καταπλήσσω_καταπλάσσω_
ὁρμῶντα	verb_verb_	ὁρμάω_ὁρμάζω_
ὡρμήθησαν	verb_verb_	ὁρμέω_ὁρμάω_
παρδαλέην	noun_adjective_	παρδαλέη_παρδάλεος_
Ὠκύαλος	adjective_noun_	ὠκύαλος_Ὠκύαλος_
τετραπόδων	adjective_adjective_	τετράποδος_τετράπους_
προσθήσειν	verb_verb_	προσθέω_προστίθημι_
Πηλείδεω	noun_noun_	Πηλεύς_Πηλείδης_
μικροῖς	adjective_adjective_	μικρός_σμικρός_
ἄντα	adverb_noun_verb_	ἄντα_ἄντη_ἀντάω_
ἂν	conjunction_preposition_particle_conjunction_	ἐάν_ἀνά_ἄν1_ἄν2_
Κύπρον	noun_noun_	κύπρος_Κύπρος_
Σώφρων	adjective_noun_	σώφρων_Σώφρων_
Θετταλίαν	noun_noun_	Θεσσαλίη_Θεσσαλία_
τελέομεν	verb_verb_	τέλλω_τελέω_
Ἠὼς	noun_noun_	Ἠώς_ἠώς_
πολυΐστορα	adjective_noun_	πολυίστορος_πολυίστωρ_
κονίῃσι	adjective_verb_noun_	κόνιος_κονίω_κονία_
οὖλον	adjective_noun_adjective_adjective_adjective_adjective_	οὐοὖος2_οὖλον_οὖλος2_οὖλονς1_οὖλος3_ὅλοξ_
ζῶσα	verb_verb_	ζώννυμι_ζάω_
Μυσία	adjective_verb_noun_	Μύσιος_μυσιάω_μυσία_
μακρὰν	adjective_adverb_	μακρός_μακράν_
δαιτρὸν	noun_noun_	δαιτρόν_δαιτρός_
Ἑλένην	noun_noun_	Ἑλένη_ἑλένη_
καταβήμεναι	verb_verb_	καταβαίνω_καθάπτω_
ἐπίστασαι	verb_verb_verb_	ἐπιστάζω_ἐπίσταμαι_ἐφίστημι_
Τρώϊοι	adjective_adjective_adjective_	Τρωιόστρωιός_Τρωιός_Τρώιος_
Κυζικηνῶν	adjective_adjective_	Κυζικηνός_Κύζικος_
ἐρινεὸν	noun_noun_	ἐρινεόν_ἐρινεός_
ἐπισταμένως	verb_verb_verb_adverb_	ἐπίσταμαι_ἐπιστάζω_ἐφίστημι_ἐπισταμένως_
ἔγχη	verb_noun_verb_	ἐγχέω_ἔγχος_ἐγχύνω_
ψαύσει	verb_noun_	ψαύω_ψαῦσις_
πεφρικυῖαι	verb_verb_	φρίσσω_φρίζω_
κόρση	noun_noun_	κόρσης_κόρση_
Κυπρίᾳ	noun_adjective_adjective_	Κυπρία_Κύπριος_κύπριος_
ναυστάθμου	noun_noun_	ναύσταθμον_ναύσταθμος_
στῆτε	verb_noun_verb_	στάζω_στέαρ_ἵστημι_
ὕλῃ	noun_noun_	ὗλις_ὕλη_
μαχήσομαι	verb_verb_verb_verb_verb_	μαχάω_μάχομαι_μαχέω_συμ́ω_συμμαχέω_
δάπτω	verb_noun_	δάπτω_δάπτης_
ὄνομ'	verb_noun_	ὄνομαι_ὄνομα_
ἐκκλησιῶν	noun_verb_	ἐκκλησία_ἐκκλησιάζω_
ἦγμαι	verb_verb_	ἔσσομαι_ἄγω_
τρίτα	adjective_verb_	τρίτος_τριτάω_
τρεῖς	verb_numeral_	τρέω_τρεῖς_
εἶχ'	verb_verb_verb_	ἔοικα_εἴκω_ἔχω_
Αἴθρας	noun_noun_	Αἴθρη_αἴθρη_
ἀναφυομένοις	verb_verb_ἀπό-ὕ_	ἀνά-ἀφύσσω_ἀνά-φύω_ἀνά_
λύσσαν	noun_verb_	λύσσα_λυσσάω_
πάρεισιν	verb_verb_	πάρειμι1_πάρειμι2_
Ὁμήρου	noun_noun_	Ὅμηρος_ὅμηρος_
ἐμπρήσουσιν	verb_verb_	ἐμπίμπρημι_ἐμπρήθω_
μάχας	noun_verb_	μάχη_μαχάω_
χρῆσθαι	verb_verb_verb_verb_	χράομαι_χράω1_χράω2_χραύω_
προστάσσειν	verb_verb_	προστάσσω_προσστάζω_
γένναν	noun_noun_verb_	γέννας_γέννα_γεννάω_
ἔρξει	verb_verb_	ἔρδω_ἔργω1_
Ἑλίκη	noun_noun_	ἑλίκη_Ἑλίκη_
κακῶς	verb_adjective_	κακόω_κακός_
πληγῇ	noun_verb_	πληγή_πλήσσω_
οἰκείοις	adjective_verb_verb_	οἰκεῖος_οἰκέω_οἰκείω_
δόξῃ	noun_verb_noun_	δόξα_δοκέω_δόξις_
ἱλάσκοντο	verb_verb_	ἱλάσκομαι_ἱλάομαι_
ἐπιθυομένας	verb_verb_	ἐπιθύω1_ἐπιθύω2_
Χαρίτων	adjective_noun_verb_noun_	χάριτος_Χάρις_χαριτόω_χάρις_
οὐδὸν	noun_noun_	οὐδός2_οὐδός1_
ἀρηΐφιλον	adjective_adjective_	Ἀρηίφιλος_ἀρηίφιλος_
κόσμια	noun_adjective_	κόσμιον_κόσμιος_
συνίστανται	verb_verb_	συνίστημι_συνιστάω_
ἀτάραχον	adjective_adjective_	ἀτάραχος_ἀτάρακτος_
τελευτῶν	verb_noun_	τελευτάω_τελευτή_
ἐπίσταιτο	verb_verb_	ἐπίσταμαι_ἐφίστημι_
Περγάμου	noun_noun_	Πέργαμος_Πέργαμον_
αἴτιόν	adjective_verb_	αἴτιος_αἰτέω_
ἔχων	verb_verb_verb_	χάω_χόω_ἔχω_
σὲ	adjective_pronoun_	σός_σύ_
Ἀθηναίης	noun_adjective_	Ἀθήνη_Ἀθηναῖος_
Ὠλενίης	adjective_adjective_noun_	Ὠλένιος_ὠλένιος_Ὠλενίη_
πλήρους	adjective_verb_	πλήρης_πληρόω_
κωλύσει	verb_noun_noun_	κωλύω_κώλῡσις_κώλυσις_
ἔσωσεν	verb_verb_	σώζω_εἰσωθέω_
ἐσάλπιζον	verb_verb_	σαλπίζω_ἐνσαλπίζω_
αἰδοῖα	noun_adjective_	αἰδοῖον_αἰδοῖος_
σιδηρείη	adjective_adjective_noun_	σιδήρειος_σιδήρεος_σιδηρεία_
παρέργως	adjective_adverb_adverb_	πάρεργος_πάρεργον_παρέργως_
ἀκούσῃ	verb_noun_verb_verb_adjective_	ἀκέω_ἄκουσις_ἀκούω_άω_ἀέκων_
νομᾶς	noun_verb_noun_	νομεύς_νομάζω_νομή_
νεύσομαι	verb_verb_	νέω1_νεύω_
χρόνου	verb_noun_	χρονόω_χρόνος_
ἐπινεύσομαι	verb_verb_	ἐπινέω3_ἐπινεύω_
κάλλιον	adjective_adverb_	καλός_κάλλιον_
ἐκδεξώμεθα	verb_verb_	ἐκδέχομαι_ἐκδείκνυμι_
πυρκαϊῆς	noun_adjective_	πυρκαιά_πυρκαιός_
χρώμενος	verb_verb_verb_verb_	χράω2_χραύω_χράομαι_χράω1_
ἐμπρῆσαι	verb_verb_	ἐμπίμπρημι_ἐμπρήθω_
πείρατ'	verb_noun_	πείρω_πεῖραρ_
Θρύον	noun_noun_	Θρύον_θρύον_
ἀποκοπῇ	verb_noun_verb_	ἀποκοπέομαι_ἀποκοπή_ἀποκόπτω_
ἐκπλαγείς	verb_verb_	ἐκπλήσσω_ἐκπλάσσω_
Λικυμνίου	noun_noun_	Λικύμνιον_Λικύμνιος_
κηλέω	adjective_verb_	κήλεος_κηλέω_
δάκρυον	noun_verb_	δάκρυον_δακρύω_
λόγιον	adjective_noun_	λόγιος_λόγιον_
Μελέταις	noun_noun_	Μέλετα_Μελέτη_
ψιλῆς	noun_adjective_	ψιλεύς_ψιλός_
λάᾶν	verb_verb_	λάω2_λάω1_
ῥῶσαι	verb_verb_verb_verb_	ῥώομαι_ῥαίνω_ῥώννυμι_ῥάζω_
παρώρμησεν	verb_verb_	παρορμέω_παρορμάω_
βουλῇ	noun_noun_	βουλή_βουλεύς_
ἱερῷ	verb_adjective_	ἱεράζω_ἱερός_
κεῖνοι	pronoun_adjective_	ἐκεῖνος_κεῖνος_
δειλοῖο	verb_adjective_	δειλόομαι_δειλός_
ἀφορῶσιν	verb_verb_	ἀφοράω_ἀφορέω_
λίθου	verb_noun_verb_	λιθόομαι_λίθος_λιθόω_
ἐμυήθη	verb_verb_	μυάω_μυέω_
ἔφοδον	noun_noun_adjective_	ἔφοδος3_ἔφοδος2_ἔφοδος1_
ψυχῇ	verb_noun_verb_	ψυχάζω_ψυχή_ψύχω_
ἕξει	noun_verb_	ἕξις_ἔχω_
Ἑλένη	noun_noun_	ἑλένη_Ἑλένη_
γερῶν	noun_verb_	γέρας_γεράζω_
ἐκτεταμένως	adverb_verb_	ἐκτεταμένως_ἐκτείνω_
ἀθροῖσαι	verb_verb_	ἀθρέω_ἀθροίζω_
λογίαν	noun_adjective_	λογία_λόγιος_
ἀγρίων	verb_verb_adjective_verb_	ἀγρέω_ἀγριάω_ἄγριος_ἀγριόω_
Κελαινώ	adjective_noun_	κελαινός_Κελαινώ_
ἐθεᾶτο	verb_verb_	θεάω_θεάομαι_
γράφει	noun_verb_	γράφος_γράφω_
ἄξω	verb_noun_verb_	ἄγνυμι_ἄξος_ἄγω_
διάμετρον	noun_noun_	διάμετρος_διάμετρον_
σαώτερος	adjective_adjective_	σάος_σῶς_
Πύθιον	noun_adjective_	Πύθιον_Πύθιος_
τίσι	noun_pronoun_irregular_	τίσις_τις_τίς_
λεγομένων	verb_verb_verb_	λέγω1_λέγω2_λέγω3_
Ἠέλιος	noun_noun_noun_	ἥλιος_ἠέλιος_Ἥλιος_
ἐνίοις	adjective_verb_	ἔνιοι_ἔνειμι_
μέλαν	adjective_noun_	μέλας_μέλη_
ζῶσαν	verb_verb_	ζάω_ζώννυμι_
τιμήσουσιν	verb_verb_	τιμάω_τιμέω_
χρυσίου	noun_adjective_	χρυσίον_χρύσεος_
μύρου	verb_noun_noun_verb_	μύρω_μύρον_μῦρος_μυρόω_
ὄπισθεν	adverb_verb_	ὄπισθεν_ὀπίζω_
κεκτῆσθαι	verb_verb_	κτάομαι_κτέομαι_
ἀυτῆς	verb_noun_	ἀυτέω_ἀυτή_
δευόμενον	verb_verb_verb_verb_	δέω2_δεύω2_δεύομαι_δεύω1_
ἀστέρων	noun_verb_	ἀστήρ_ἀστερόω_
θανατηφόρους	adjective_adjective_	θανατηφόρος_θανατήφορος_
ἤρξατο	verb_verb_	ἔρδω_ἄρχω_
πέπλῳ	adjective_noun_	πεπλος_πέπλος_
τελευτᾷ	noun_verb_	τελευτή_τελευτάω_
πέπλον	adjective_noun_	πεπλος_πέπλος_
Κῦνον	noun_noun_	Κῦνος_Κῦνον_
ἐμαντεύοντο	verb_verb_	μαντεύομαι_μαντεύω_
δικαίας	adjective_noun_	δίκαιος_δικαία_
Λάμπε	noun_verb_	Λάμπος_λάμπω_
γραφήν	noun_noun_	γραφής_γραφή_
ὀδυνῶν	verb_noun_	ὀδυνάω_ὀδύνη_
Ἀντήνωρ	noun_noun_	ἀντήνωρ_Ἀντήνωρ_
Ἀλθαία	noun_noun_	Ἄλθαία_ἀλθαία_
τεύχε'	noun_verb_	τεῦχος_τεύχω_
φύει	verb_noun_	φύω_φύος_
μάλ'	noun_adverb_	μάλη_μάλα_
οἰκείους	verb_adjective_	οἰκειόω_οἰκεῖος_
Μυσῶν	verb_noun_verb_noun_verb_noun_noun_verb_adjective_	μυσόω_μυσόν_μύζωω_μύσος_μύω_μυσή_Μυσός_μύζω_μυσός_
οὖρος	noun_noun_noun_noun_noun_	οὐρόσς_οὐρός_οὖροσὖρος4_οὖρος1_οὖρος2_
χαλκέην	adjective_adjective_	χαλκοῦς_χάλκεος_
Θράκῃ	noun_noun_	Θράκευς_Θράκη_
ὁδοῦ	noun_verb_noun_verb_	ὁδός1_ὁδάω_ὁδός2_ὁδόω_
περισσῶς	adjective_adverb_	περισσός_περισσῶς_
ἅγε	adverb_verb_	ἄγε_ἄγω_
ἀξὶοι	verb_verb_	ἄγω_ἄγνυμι_
κεχολωμένον	verb_verb_	χολόομαι_χολόω_
κορμῶν	noun_verb_	κορμός_κορμάζω_
σαώσει	verb_verb_	σώζω_σαόω_
θέρμον	noun_verb_	θέρμος_θέρμω_
ἐπέγημεν	verb_verb_	ἐπιγαμέω_πέσσω_
σαρκί	noun_noun_	σαρκίς_σάρξ_
θεείου	adjective_noun_verb_adjective_noun_verb_	θεεῖος_θέειον_θειόω_θεῖος1_θεῖον1_θεειόω_
ἕλην	noun_noun_	ἕλη_ἕλος_
δέοντος	verb_verb_noun_verb_	δέω2_δεῖ_δέον_δέω1_
βοηθῶν	verb_adjective_	βοηθέω_βοηθός_
πρεσβείαι	noun_noun_	πρεσβεία_πρέσβεια_
θεῖε	noun_adjective_verb_	θεῖος2_θεῖος1_θέω_
Ἀττικὰς	noun_adjective_	Ἀττική_Ἀττικός_
καναχὴν	noun_adjective_	καναχή_καναχός_
Πόδαργέ	adjective_noun_	πόδαργος_Πόδαργος_
προστάσσει	verb_verb_	προστάσσω_προσστάζω_
ἀμᾶσθαι	verb_verb_	ἀμάω1_ἀμάω2_
καθαρῶν	verb_adjective_	καθαίρω_καθαρός_
χρωμένῳ	verb_verb_verb_verb_	χράομαι_χράω2_χράω1_χραύω_
ἅκοντα	noun_adjective_	ἄκων_ἀέκων_
ἀχέων	noun_verb_verb_noun_verb_	ἠχή_ἠχέω_ἀχέω2_ἄχος_ἀχεύω_
αἴθε	conjunction_exclamation_	αἴθε_εἴθε_
ῥινὸς	noun_noun_	ῥινός_ῥίς_
φυτοῦ	noun_adjective_verb_	φυτόν_φυτός_φυτόομαι_
ἐρῷ	verb_verb_	ἐράω1_ἐράω2_
εἴξω	verb_verb_	εἴκω_ἔοικα_
μέσας	noun_adjective_noun_	μέσης_μέσος_μέση_
ἤϊα	noun_noun_verb_	ἤια_ᾖα_εἶμι_
πλάττουσι	verb_verb_	πλήσσω_πλάσσω_
τ'	pronoun_particle_	σύ_τε_
Δαναοῖσι	noun_noun_	Δαναοί_Δαναός_
μαχήσονται	verb_verb_	μάχομαι_συμμαχέω_
Δαρδάνιαι	adjective_noun_	Δαρδάνιος_Δαρδανία_
ὁρμήσας	verb_verb_	ὁρμέω_ὁρμάω_
Ὅμηρον	noun_noun_	Ὅμηρος_ὅμηρος_
φίλα	noun_adjective_	φῖλος_φίλος_
δείξεως	noun_noun_	δείξις_δεῖξις_
ἕλικος	noun_noun_	ἕλιξ1_ἕλιξ2_
φρίσσει	verb_verb_	φρίζω_φρίσσω_
χρόνων	noun_verb_	χρόνος_χρονόω_
μῆλ'	noun_noun_noun_	μῆλον2_μῆλον1_μήλη_
τρίτης	verb_adjective_	τριτάω_τρίτος_
Αἰπὺ	adjective_noun_	αἰπύς_Αἰπύ_
ὥρμησαι	verb_verb_	ὁρμέω_ὁρμάω_
χρόνους	noun_verb_	χρόνος_χρονόω_
ἀναδούσης	verb_verb_	ἀναδίδωμι_ἀναδέω_
ἱπποφόρβιον	noun_verb_	ἱπποφόρβιον_ἱπποφορβέω_
ἄκροις	noun_adjective_	ἄκρον_ἄκρος_
ἐπιτίμησιν	noun_verb_	ἐπιτίμησις_ἐπιτιμάω_
σταθμὸν	noun_noun_	σταθμός_σταθμόν_
ὀξέως	adverb_adjective_	ὀξέως_ὀξύς2_
Ὕλαι	noun_noun_	ὕλη_Ὕλη_
Χρυσῆς	noun_adjective_	Χρυσεύς_χρύσεος_
ἴ̈̈σως	verb_adjective_adverb_	ἰσόω_ἴσος_ἴσως_
θύων	verb_verb_verb_noun_	θύω2_θυάω_θύω1_θύον_
χείμαρροι	adjective_adjective_	χειμάρρους_χείμαρρος_
τῆι	adverb_article_	τῇ_ὁ_
Αἰολίδα	noun_noun_noun_	Αἰολεύς_Αἰολίς_Αἰολίδης_
παράλιον	adjective_noun_	παράλιος_παράλιον_
κλῆϊς	noun_verb_	κλείς_κλάω_
κύνας	verb_noun_	κυνάω_κύων_
πόλις	noun_noun_	πόλις_πόόλις_
αὐγῇ	verb_noun_verb_	αὐγέω_αὐγή_αὐγάζω_
ἐξαίρετον	verb_adjective_	ἐξαίρω_ἐξαιρετός_
προϊῶ	verb_verb_verb_verb_	πρό-ἱέω_πρό-ἰάζω_πρό-ἰάομαι_πρό-ἰόω_
Ὕλῃ	noun_noun_noun_	ὕλη_Ὕλη_ὗλις_
γνώσῃ	noun_verb_	γνῶσις_γιγνώσκω_
ἀμοιβὰς	noun_noun_	ἀμοιβάς_ἀμοιβή_
Αὐγέα	adjective_noun_	αὐγής_Αὐγέας_
πεδίω	verb_verb_noun_noun_verb_	μέτειμι2_μέτειμι1_πέδιον_πεδίον_πεδάω_
τροφῆς	verb_noun_noun_verb_	τροφέω_τρόφις_τροφή_τρέφω_
ἰδοῦ	verb_verb_	εἶδον_ἰδέω_
Ἀχάτην	noun_noun_	ἀχάτης_Ἀχάτης_
Ἐπαφρόδιτος	noun_adjective_	Ἐπαφρόδιτος_ἐπαφρόδιτος_
ἕρματα	noun_noun_	ἕρμα2_ἕρμα1_
τιμήσας	verb_verb_	τιμάω_τιμέω_
Θράκη	noun_noun_	Θράκευς_Θράκη_
φυλασσόμενος	verb_verb_	φυλάζω_φυλάσσω_
ἄθλων	noun_noun_	ἆθλον_ἆθλος_
ὑπερτέρην	adjective_adjective_	ὑπέρτερος_ὑπέρ_
κίον	verb_verb_	κέω_κίω_
ἐξείης	verb_verb_	ἐξίημι_ἔξεστι_
ποιοῦσι	verb_verb_	ποιόω_ποιέω_
Φόβον	noun_noun_	φόβος_Φόβος_
ἐπίστασαὶ	verb_verb_verb_	ἐπίσταμαι_ἐπιστάζω_ἐφίστημι_
χρυσοῖο	noun_verb_adjective_	χρυσός_χρυσόω_χρύσεος_
δαιμόνων	verb_noun_	δαιμονάω_δαίμων_
ἐκδεξαίμεθα	verb_verb_	ἐκδείκνυμι_ἐκδέχομαι_
ἐπανῶ	verb_verb_	πανάω_ἐπανίημι_
φάρους	noun_verb_noun_	φάρος_φαρόω_φᾶρος_
λωτοῦντα	adjective_verb_	λωτόεις_λωτέω_
ἔρξε	verb_verb_	ἔργω1_ἔρδω_
κλίνας	verb_noun_	κλίνω_κλίνη_
ἔπεισε	verb_verb_	ἐφίζω_πείθω_
τελείωσιν	noun_verb_	τελείωσις_τελέω_
παραβάτης	noun_verb_	παραβάτης_παραβατέω_
φωνῶν	noun_verb_	φωνή_φωνέω_
ἀνεπαίσθητον	verb_adjective_	ἀναπαίω_ἀνεπαίσθητος_
πηγὰς	noun_noun_adjective_	πηγή_πηγάς_πηγός_
τέλη	noun_verb_	τέλος_τελέω_
νευρὰν	noun_noun_	νευρή_νευρά_
ἐδάφους	noun_verb_	ἔδαφος_ἐδαφόω_
ὄρθρου	noun_verb_	ὄρθρος_ὀρθρόω_
Πηλείωνα	noun_noun_	Πηλείων_Πηλεύς_
προσθετέον	adjective_verb_adjective_	προσθετέον_προσθετέω_προσθετέος_
λεγομένου	verb_verb_verb_	λέγω2_λέγω1_λέγω3_
ἤν	conjunction_exclamation_	ἐάν_ἤν_
προσληπτέον	adjective_adjective_	προσληπτέος_προσληπτέον_
λαμπάδα	noun_noun_	λαμπάς2_λαμπάς1_
ἠριγένεια	noun_noun_	ἠριγένειον_ἠριγένεια_
γυναικοκρατεῖται	verb_verb_	γυναικοκρατέομαι_γυναικοκρατέω_
εἰκυῖα	verb_verb_	εἰκός_ἔοικα_
ἀπαλλάσσεσθαι	verb_verb_	ἀπαλλάσσω_ἀπαλλαξείω_
πῶ	adverb_particle_	πῶ_πω_
χαρίσασθαι	verb_verb_	χαρίζω_χαρίζομαι_
κυνέην	adjective_noun_noun_	κύνεος_κυνέα_κυνέη_
λύχνα	noun_noun_	λύχνος_λύχνον_
οὐρῆας	noun_noun_	ὀρεύς_οὐρεύς_
νοούμενον	verb_verb_	νοέω_νοόω_
κριθῆς	noun_verb_	κριθή_κριθάω_
ῥιγοῦν	verb_verb_	ῥιγέω_ῥιγόω_
σφῶϊ	pronoun_adjective_verb_	σύ_σφός_σφάζω_
νοοῦσι	verb_verb_	νοόω_νοέω_
Παιήονα	noun_noun_	Παιάν_Παιήων_
χαριζομένη	verb_verb_	χαρίζω_χαρίζομαι_
φιλίαν	adjective_noun_	φίλιος_φιλία_
ὅλων	adjective_verb_adjective_	ὅλοξ_ὁλάω_ὅλος_
Ἡρακλέων	noun_noun_	Ἡρακλέος_Ἡρακλέων_
καταγάζονται	verb_verb_	κατά-ἄγαμαι_κατά-ἀγάζω_
Ἡρακλείῃ	adjective_noun_	Ἡράκλειος_Ἡράκλεια_
δύνηται	verb_verb_	δύναμαι_δύω2_
Αἰδοῦς	noun_noun_	αἰδώς_αἰδώ_
τιμῶν	verb_verb_noun_verb_	τιμέω_τιμόω_τιμή_τιμάω_
ὅμοιον	adjective_adjective_	ὅμοιος_ὁμοῖος_
φθάσωσιν	verb_verb_	φθάζω_φθάνω_
σοῦ	verb_pronoun_exclamation_adjective_verb_	σέω_σύ_σοῦ_σός_σεύω_
Αἰπύ	adjective_noun_	αἰπύς_Αἰπύ_
Φοίνικα	noun_noun_	Φοῖνιξ_φοῖνιξ_
Πύρασον	verb_noun_	πυράζω_Πύρασος_
Ἀλεξάνδρῳ	noun_adjective_	Ἀλέξανδρος_ἀλέξανδρος_
πυρκαϊὰς	noun_adjective_	πυρκαιά_πυρκαιός_
Κάειρ'	noun_noun_	Κάειρα_Κάρ_
χωρίον	noun_verb_	χωρίον_χωρέω_
περιέχει	verb_verb_	περιέχω_περιχέω_
φορὰς	noun_noun_	φοράς_φορά_
ὁμοίως	adjective_adjective_verb_	ὅμοιος_ὁμοῖος_ὁμοιόω_
λεγόμενοι	verb_verb_verb_	λέγω2_λέγω3_λέγω1_
ἀνῆκε	verb_verb_	ἀνίημι_ἀνήκω_
δακρύων	noun_verb_	δάκρυον_δακρύω_
ἤρως	noun_verb_	ἦρος_ἀρόω_
φανήσεται	verb_verb_	φαίνω_φανάω_
κρίκοι	noun_verb_	κρίκος_κρίζω_
διαδήλως	adjective_verb_	διάδηλος_διαδηλόω_
εἶεν	verb_particle_	εἰμί_εἶεν_
Τροΐην	noun_verb_	Τροία_τρέω_
τετρώρῳ	noun_adjective_adjective_	τέτρωρον_τετράορος_τέτρωρος_
μεθύσω	noun_verb_adjective_	μεθύσης_μεθύσκω_μέθυσος_
Ἀχαιαὶ	noun_adjective_	ἀχαιά_Ἀχαιός_
Λαοδόκῳ	noun_noun_	Λαόδοκος_Λαοδόκος_
ἁμαρτήσεται	verb_verb_	ἁμαρτέω_ἁμαρτάνω_
νόῳ	verb_noun_	νάω_νόος_
οὔλῳ	noun_adjective_adjective_adjective_adjective_adjective_	οὖλον_ὅλοξ_οὖλος2_οὖλονς1_οὖλος3_οὐοὖος2_
μύες	verb_noun_	μύω_μῦς_
ἄγη	verb_noun_noun_	ἀγάω_ἄγη_ἄγος_
χαλκέω	adjective_adjective_	χαλκοῦς_χάλκεος_
ἐχαρίσατο	verb_verb_	χαρίζομαι_χαρίζω_
ξένους	verb_noun_adjective_	ξενόω_ξένος1_ξένος2_
αἴ	exclamation_conjunction_	αἴ_εἰ_
Μώμου	noun_noun_	μῶμος_Μῶμος_
λόγων	verb_noun_	λογάω_λόγος_
ἐλεήσας	verb_verb_	ἐλεέω_ἐλεάω_
Μύρης	noun_verb_	Μύρα_μύρω_
παριστάμενον	verb_verb_	παριστάω_παρίστημι_
Σίγιον	verb_noun_	σιγάω_σίγιον_
στρατεῦσαι	verb_verb_verb_	στρατόω_στρατάω%2_στρατεύω_
διαστολῇ	noun_noun_	διαστολή_διαστολεύς_
Ἄσην	verb_verb_noun_	ἄω3_ἀσάω_ἄση_
Τηλεμάχοιο	adjective_adjective_noun_	τηλέμαχος_τηλεμάχος_Τηλέμαχος_
ἁλώμενος	verb_verb_	ἀλόω_ἐλαύνω_
ἐστραμμένην	verb_verb_	στρέφω_στράπτω_
Ἁρμονία	noun_noun_	Ἁρμονία_ἁρμονία_
ἀρετῇ	noun_verb_	ἀρετή_ἀρετάω_
τραπέντος	verb_verb_	τέρπω_τρέπω_
φίλω	adjective_verb_verb_	φίλος_φιλέω_φιλόω_
λέξω	verb_verb_verb_	λέγω1_λέγω3_λέγω2_
εἰρεῖν	verb_verb_	ἐρῶ_εἰρέω_
ἀφέξει	verb_noun_	ἀπέχω_ἄφεξις_
πέπλου	adjective_noun_	πεπλος_πέπλος_
ἔνεσαν	verb_verb_	ἐνέζομαι_ἐνίημι_
ἐπίσσωτρα	noun_noun_	ἐπίσσωτρον_ἐπίσωτρον_
θοῇ	verb_adjective_	θοάζω_θοός_
συνέδησεν	verb_verb_	συνδέω_συνδέομαι_
ἐκείνου	pronoun_verb_	ἐκεῖνος_κενόω_
παρεπιτιμῶντι	verb_ἐπί-τιμό_ἐπί-τιμέ_	παρά-ἐπιτιμάω_παρά_παρά_
Κλειτὸς	adjective_noun_	κλειτός_Κλειτός_
ἀνάσσων	verb_verb_	ἀνάσσω_ἀνάζω_
ἀνδρείους	adjective_verb_	ἀνδρεῖος_ἀνδρειόω_
ἐμοῦ	adjective_pronoun_verb_	ἐμός_ἐγώ_ἐμέω_
εἰκῇ	adverb_verb_	εἰκῇ_εἰκάζω_
τοὐναντίον	adverb_adjective_	ἐναντίον_ἐναντίος_
αἴτιον	verb_adjective_	αἰτέω_αἴτιος_
ὁμοίϊον	adjective_adjective_	ὁμοίιος_ὅμοιος_
τρίτη	adjective_verb_	τρίτος_τριτάω_
Ἕκτορος	noun_noun_	Ἕκτωρ_ἕκτωρ_
ὁρμῶν	noun_verb_verb_verb_	ὁρμή_ὁρμάζω_ὁρμέω_ὁρμάω_
λέξει	verb_verb_verb_verb_noun_verb_	λέγω1_λέγλέγω2_λέγω3_λέγω2_λέξις_γω3_
ὄρουσ'	noun_verb_	ὄρουσις_ὀρούω_
ἐμψύχου	verb_adjective_	ἐμψυχόω_ἔμψυχος_
Λιλαίῃσι	noun_noun_	Λίλαια_Λιλαια_
φαντάζει	verb_verb_	φαντάζω_φαντάζομαι_
ἄθλου	noun_noun_	ἆθλον_ἆθλος_
πρώονες	noun_noun_	πρών_πρώων_
τρόπους	noun_verb_	τρόπος_τροπόω_
Ἄπιδος	noun_noun_	Ἆπις_Ἀπις_
ὁρίζοντος	verb_noun_	ὁρίζω_ὁρίζων_
Πυθίαν	noun_adjective_	Πυθία_Πύθιος_
ὑπήκοος	adjective_adjective_	ὑπήκοος_ὑπήκους_
κεκεντῆσθαι	verb_verb_	κεντάω_κεντέω_
ἁπαλλασσόμενοι	verb_verb_verb_	ἐπαλλάσσω_ἀπαλλαξείω_ἀπαλλάσσω_
θ᾽	particle_pronoun_	τε_σύ_
Λαΐς	noun_noun_	Λαίς_ληίς_
αἴσιος	adjective_noun_	αἴσιος_αἶσις_
τῇ	adverb_article_	τῇ_ὁ_
Λαομέδοντι	noun_noun_	Λαομέδων_λαομέδων_
ἔσσεταί	verb_verb_	ἔσσομαι_εἰμί_
τάφω	noun_verb_	τάφος1_τέθηπα_
πόσιος	noun_noun_	πόσις2_πόσις1_
πρώτων	adjective_adjective_	πρότερος_πρῶτος_
βουκόλου	noun_noun_	βούκολος_βουκόλος_
κέντρων	noun_noun_verb_	κέντρων_κέντρον_κεντρόω_
ἔναυλοι	noun_adjective_	ἔναυλος1_ἔναυλος2_
τρύγα	noun_verb_noun_noun_	τρύξ_τρυγάω_τρύγη_τρύγος_
θρόνῳ	noun_noun_	θρόνον_θρόνος_
παρῴδηται	verb_verb_	παρά-οἰδάω_παρά-οἰδέω_
παρά	preposition_adjective_	παρά_πηρός_
ἐμέων	adjective_verb_	ἐμός_ἐμέω_
ἀθανάτων	verb_adjective_	ἀθανατόω_ἀθάνατος_
ἀγωνία	verb_noun_	ἀγωνιάω_ἀγωνία_
ἐνηλλαγμένως	adverb_verb_	ἐνηλλαγμένως_ἐναλλάσσω_
σειρᾶς	verb_noun_	σειράω_σειρά_
παριοῦσι	verb_verb_verb_	παρίζω_πάρειμι1_πάρειμι2_
πορφύρεον	verb_adjective_	πορφυρέω_πορφύρεος_
Ἄρεω	noun_noun_	Ἄρης_ἀρά_
πίσω	verb_noun_noun_	πιπίσκω_πίσον_πίσος_
κεινός	adjective_adjective_	κεινός_κενός_
ἐμεῖο	pronoun_verb_	ἐγώ_ἐμέω_
νεώτεροι	adjective_adjective_	νεώτερος_νέος_
χωρίων	verb_noun_	χωρέω_χωρίον_
ἀτέρπου	adjective_adjective_	ἀτερπής_ἄτερπος_
φήμη	noun_noun_	φῆμις_φήμη_
ἔσωθεν	verb_adverb_	σώζω_ἔσωθεν_
παρασυνίστησι	verb_verb_	παρά-συνιστάω_παρά-συνίστημι_
μὰν	particle_noun_	μήν_μής_
χραύσῃ	noun_verb_	χραῦσις_χραύω_
εἰρόμενος	verb_verb_verb_	εἴρω2_ἔρομαι_εἴρω_
Ὕδη	noun_noun_verb_	ὕδης_Ὕδη_ὑδέω_
λίνον	noun_noun_	λίνος_λίνον_
νίκης	verb_noun_	νικάω_νίκη_
ὤρετο	verb_verb_	ὄρνυμι_ὄρομαι_
οἶσι	noun_verb_	οἶσις_εἰμί_
αἰχμῇ	verb_noun_	αἰχμάζω_αἰχμή_
καλλίροον	adjective_adjective_	καλλίρους_καλλίροος_
προϊέναι	verb_verb_	πρόειμι1_προίημι_
ἐμψύχων	verb_adjective_	ἐμψυχόω_ἔμψυχος_
Ὀδυσσείᾳ	noun_adjective_	Ὀδύσσεια_Ὀδύσσειος_
ἀγοίμεθα	verb_verb_	ἀγάω_ἄγω_
Αἰτωλῶν	adjective_noun_	Αἰτωλός_Αἰτωλοί_
κλαγγῆς	noun_verb_verb_	κλαγγή_κλαγγάζω_κλαγγέω_
λιπούσης	verb_verb_	λιπάω_λείπω_
στείρῃ	noun_noun_	στεῖρα1_στεῖρα2_
Τρῴας	noun_adjective_	Τροία_Τριός_
Ἄσιος	noun_adjective_adjective_	ἄσις_ἄσιος_Ἄσιος_
πολεμούντων	verb_verb_	πολεμέω_πολεμόω_
ζῴων	noun_noun_verb_	ζῷον_ζώιον_ζῳόω_
ἔστασαν	verb_verb_	στάζω_ἵστημι_
θήλειαν	verb_adjective_	θάλλω_θῆλυς_
θεάσασθαι	verb_verb_	θεάομαι_θεάω_
Λοκρίδι	noun_noun_	Λοκρίς_Λοκρός_
ὕπνῳ	noun_noun_	ὕπνος_ὕπνον_
σαωθῆναι	verb_verb_	σαόω_σώζω_
ἴ̈σω	adjective_verb_	ἴσος_ἰσόω_
ἤχθησαν	verb_verb_verb_verb_	ἀχθέω_ἔσσομαι_ἄγω_ἐχθέω_
ξεῖνον	adjective_noun_	ξένος2_ξένος1_
Ἀγήνωρ	noun_noun_	ἀγήνωρ_Ἀγήνωρ_
πρῶτοι	adjective_adjective_	πρῶτος_πρότερος_
κατωτέρου	adjective_adjective_	κατώτερος_κάτος_
λείψω	verb_verb_	λείβω_λείπω_
ἀκουσίως	adjective_adjective_	ἀκούσιος_ἀεκούσιος_
ὁμωνυμία	adjective_adjective_noun_	ὁμώνυμος_ὁμωνύμιος_ὁμωνυμία_
Δαρδανίων	adjective_noun_	Δαρδάνιος_Δαρδανίων_
μεταγενέστερος	adjective_adjective_	μεταγενής_μεταγενέστερος_
ποιητοῦ	noun_adjective_	ποιητής_ποιητός_
ὁδ'	noun_pronoun_noun_	ὁδός2_ὅδε_ὁδός1_
Ἐνετοῖς	adjective_noun_	ἐνετός_Ἐνετοί_
γύην	verb_noun_noun_	ἐγγυάω_γύης2_γύης1_
ταγείη	noun_verb_	ταγεία_τάσσω_
ἐνάρων	adjective_noun_verb_	ἔναρος_ἔναρα_ἐνᾶρόω_
πρώτοις	adjective_adjective_	πρότερος_πρῶτος_
πράξεις	noun_verb_	πρᾶξις_πράσσω_
γυμνοῦ	adjective_verb_	γυμνός_γυμνόω_
βλάβης	noun_verb_	βλάβη_βλάπτω_
ἔρξον	verb_verb_	ἔρδω_ἔργω1_
ἐπικληθεὶς	verb_verb_	ἐπικαλέω_ἐπικλάω_
Κώπας	verb_noun_noun_	κωπάω_κώπη_Κώπαι_
διάπυρον	adjective_adjective_	διάπυρος_διαπυρος_
λέγηαι	verb_verb_verb_	λέγω1_λέγω3_λέγω2_
Ἀλθαίας	noun_noun_noun_	Ἄλθαία_ἀλθαία_Ἀλθαίη_
κακοπαθίας	noun_noun_	κακοπαθία_κακοπάθεια_
τελέει	verb_verb_	τέλλω_τελέω_
ἀνηρημένης	verb_verb_verb_verb_verb_	ἀνά-ἐράομαι_ἀνά-ἀράω2_ἀνά-ἐρέω_ἀνά-ἐρέομαι_ἀνά-ἀρέομαι_
κλείουσιν	verb_verb_	κλείω2_κλέω_
Μούσας	noun_noun_	Μοῦσαι_Μοῦσα_
τιθὴ	adjective_noun_	τιθός_τιθή_
τὶς	pronoun_irregular_	τις_τίς_
τάχα	noun_adjective_adverb_	τάχος_ταχύς_τάχα_
πρόσσω	adverb_verb_	πρόσω_πρόσσω_
ἐκείνων	verb_pronoun_	κενόω_ἐκεῖνος_
λίθω	verb_verb_noun_	λιθόω_λιθόομαι_λίθος_
ἀργὸν	adjective_adjective_	ἀργός1_ἀργός2_
Βοιωτίαν	noun_adjective_	Βοιωτία_Βοιώτιος_
ἔφυσαν	verb_verb_verb_	ἐφύω_φύω_φύζω_
χέωσι	verb_verb_	χάω_χέω_
ἐξεδέξατο	verb_verb_	ἐκδέχομαι_ἐκδείκνυμι_
Ἄλεξις	noun_noun_	Ἄλεξις_ἄλεξις_
Ἡρακλείδης	noun_noun_	Ἡρακλείδης_Ἡρακλείδαι_
δεῖπνον	noun_noun_	δεῖπνον_δεῖπνος_
Κύων	verb_noun_noun_	κύω_κύων_Κύον_
Πηλείδης	noun_noun_	Πηλεύς_Πηλείδης_
πέπλοι	noun_adjective_	πέπλος_πεπλος_
παρώρμησε	verb_verb_	παρορμέω_παρορμάω_
λιτός	adjective_noun_	λιτός_λίς2_
μαινόμεναι	noun_verb_	μαινομένη_μαίνομαι_
ποιητάς	noun_adjective_	ποιητής_ποιητός_
ῥηθέντα	verb_verb_	ῥέομαι_ἐρῶ_
παραλάσσει	verb_verb_	παρά-λάζω_παρά-λάζομαι_
ἔνθεν	adverb_verb_	ἔνθεν_ἔρχομαι_
Ἐπειοῦ	adjective_adjective_	Ἐπειοί_Ἐπειός_
κεῖνος	pronoun_adjective_	ἐκεῖνος_κεῖνος_
εἴασε	verb_verb_	ἐάω_εἰάζω_
ἔχην	verb_verb_	χάω_ἔχω_
Σηστὸν	noun_noun_	Σηστός_σηστός_
Νῶ	verb_verb_verb_verb_verb_	νέω3_νέω1_νάω_νέω_νέω2_
ἀρᾶς	verb_noun_	ἀράζω_ἀρή_
σοῖς	adjective_verb_	σός_σέω_
καθέζετο	verb_verb_	κατά-καθέζομαι_κατά-ἕζομαι_
ἀφορμῆς	noun_verb_	ἀφορμή_ἀφορμάω_
οἰνοφόρον	noun_adjective_	οἰνοφόρον_οἰνοφόρος_
περὶστύλον	noun_adjective_	περίστυλον_περίστυλος_
καλιάς	noun_noun_	καλιά_καλιάς_
φιλῶ	verb_verb_	φιλόω_φιλέω_
πῶμ'	noun_noun_	πῶμα2_πῶμα1_
ῥέω	noun_verb_	ῥέον_ῥέω_
κυνέα	noun_adjective_noun_	κυνέα_κύνεος_κυνέη_
ἀκόντων	noun_adjective_	ἄκων_ἀέκων_
ἄμμε	pronoun_adjective_noun_	ἐγώ_ἁμός1_ἄμμος_
ζυγῶν	verb_verb_noun_noun_noun_	ζυγόω_ζυγέω_ζυγός_ζυγόν_ζυγή_
φθεῖρα	verb_noun_	φθείρω_φθείρ_
μέρη	noun_noun_	μέρος_μέρα_
μόσχοισι	noun_noun_	μόσχος2_μόσχος1_
Φωκεὺς	noun_noun_	Φωκεύς_φωκεύς_
Κρόνον	noun_noun_	Κρόνος_κρόνος_
δεύεσθαι	verb_verb_verb_	δεύομαι_δέω2_δεύω2_
τάξει	verb_verb_noun_	τήκω_τάσσω_τάξις_
συνεπιβαρύνας	verb_ἐπί-βαρύν_	σύν-ἐπιβαρύνω_σύν_
ἀπεδέξαντο	verb_verb_	ἀποδείκνυμι_ἀποδέχομαι_
Λικύμνιον	noun_noun_	Λικύμνιος_Λικύμνιον_
ἐπιειμένε	verb_verb_verb_	ἐφέζομαι_ἐφίημι_ἐπιέννυμι_
δώσοντος	noun_verb_	δώσων_δίδωμι_
ἔρεξα	verb_verb_	ῥέζω_ἐρέσσω_
Σκύρω	noun_noun_noun_noun_	Σκύρας_Σκῦρος_σκῦρος_σκύρον_
ἅδε	noun_verb_pronoun_	ἅδος_ἁνδάνω_ὅδε_
ἐκτομῆς	verb_noun_noun_	ἐκτομάζω_ἐκτομή_ἐκτομεύς_
βροτοῦ	verb_noun_	βροτόομαι_βροτός_
νέαν	verb_noun_adjective_	νεάω_νέα_νέος_
ἐφύλαξεν	verb_verb_	φυλάσσω_φυλάζω_
τιμήσῃ	noun_verb_	τίμησις_τιμέω_
ἐκδεξάμενοι	verb_verb_	ἐκδείκνυμι_ἐκδέχομαι_
πλείους	adjective_adjective_adjective_	πλέως_πλείωνίων_πλείων_
ἱσταμένους	verb_verb_	ἱστάω_ἵστημι_
ἡμέρας	adjective_noun_	ἥμερος_ἡμέρα_
ὑπέρτεροι	adjective_adjective_	ὑπέρτερος_ὑπέρ_
ἔτισας	verb_verb_	τίζω_τίνω_
θερμοῖς	adjective_verb_	θερμός_θερμόω_
πόλει	verb_noun_	πολέω_πόλις_
ἔργον	verb_noun_	ἔργνυμι_ἔργον_
ἰσχΐων	noun_noun_	ἴσχιον_ἰσχίον_
δεύεται	verb_verb_verb_	δέω2_δεύομαι_δεύω2_
συνιστάμενοι	verb_verb_	συνίστημι_συνιστάω_
ἡλίου	noun_verb_	ἥλιος_ἡλιόω_
ἀπορῶ	verb_verb_verb_	ἀπορέω_ἀφοράω_ἀπορραίνω_
Ῥίπην	noun_verb_noun_	Ῥίπη_ῥίπτω_ῥῖπος_
ὅλας	adjective_verb_adjective_	ὅλος_ὁλάω_ὅλοξ_
χρεῶ	verb_noun_	χράομαι_χρεώ_
λιάζετο	verb_verb_	λιάζομαι_λιάζω_
Λυκίης	adjective_noun_	Λύκιος_Λυκία_
ἐφώρμησαν	verb_verb_	ἐφορμέω_ἐφορμάω_
χερειότερος	adjective_adjective_	χερείων_χερειότερος_
Δάρης	noun_noun_noun_verb_	Δάρης_Δάρας_Δάρα_δέρω_
δυνατοῦ	adjective_verb_	δυνατός_δυνατέω_
ᾤχετ'	verb_verb_verb_	ὠίζω_ὀίζω_οἴχομαι_
ἀνθήλη	noun_verb_	ἀνθήλη_ἀναθηλέω_
στίχον	verb_noun_	στείχω_στίχος_
ὑδροφόροις	adjective_adjective_	ὑδροφόρος_ὑδρόφορος_
ἐπέτασσεν	verb_verb_verb_	πετάζω_πετάννυμι_ἐπιτάσσω_
πάσας	adjective_verb_	πᾶς_πάσσω_
οἴ´ματ'	noun_verb_	οἶμα_οἰμάω_
χέες	verb_verb_	χάω_χέω_
ἀζαλέας	noun_adjective_	ἀζαλέα_ἀζαλέος_
ἀριθμοῦ	noun_verb_	ἀριθμός_ἀριθμέω_
γραῖα	adjective_noun_	γραῖος_γραῖα_
ἡμαρτηκότι	verb_verb_	ἁμαρτέω_ἁμαρτάνω_
πόρπη	noun_verb_	πόρπη_πορπάω_
κρίνη	verb_noun_	κρίνω_κρίνον_
ἠνιῶντο	verb_verb_	ἀνιάομαι_ἀνιάω_
λάζοιτο	verb_verb_	λάζω_λάζομαι_
Χαρίτεσσιν	noun_noun_	χάρις_Χάρις_
μέσης	noun_noun_adjective_	μέσης_μέση_μέσος_
συνεκδέξασθαι	verb_verb_	σύν-ἐκδείκνυμι_σύν-ἐκδέχομαι_
Κρονίων	noun_adjective_noun_	Κρόνια_Κρόνιος_Κρονίων_
κανών	verb_noun_	καίνω_κανών_
δῶ	noun_verb_	δῶμα_δίδωμι_
Περσέα	noun_noun_noun_	περσέα_Περσεύς_Πέρσης_
ξεῖνε	noun_adjective_	ξένος1_ξένος2_
πυρά	noun_noun_	πυρή_πυρά_
ξεινοδόκος	noun_noun_	ξεινοδόκος_ξενοδόκος_
οὐτάσαι	verb_verb_	οὐτάω_οὐτάζω_
ἀποδεξάμενοι	verb_verb_	ἀποδείκνυμι_ἀποδέχομαι_
ὀρῶν	noun_noun_	ὄρος_ὀρός_
ἐπελιώθη	verb_verb_	πελιόομαι_πελιόω_
δοκῇ	noun_noun_verb_	δοκεύς_δοκή_δοκάζω_
ἐμψύχως	verb_adjective_	ἐμψυχόω_ἔμψυχος_
ὑποληπτέον	adjective_adjective_	ὑποληπτέον_ὑποληπτέος_
κεφαλαίου	verb_adjective_	κεφαλαιόω_κεφάλαιος_
ἐξέλκει	verb_verb_	ἐξελκέω_ἐξέλκω_
ἄρθρου	noun_verb_	ἄρθρον_ἀρθρόω_
Δόλων	verb_noun_noun_noun_	δολόω_Δόλων_δόλων_δόλος_
χέοντα	verb_verb_	χέω_χάω_
βίην	verb_noun_	βιάω_βία_
ἀγαθοῖς	verb_adjective_	ἀγαθόω_ἀγαθός_
κριθῶν	noun_verb_	κριθή_κριθάω_
Ἀρηϊθόοιο	noun_adjective_	Ἀρηΐθοος_Ἀρηίθοος_
Πύλον	noun_noun_	πύλος_Πύλος_
βροντῶν	verb_noun_noun_verb_	βροντάζω_βροντή_βρόντης_βροντάω_
γυάλοισιν	noun_noun_	γύαλος_γύαλον_
ἴδε	verb_adverb_	εἶδον_ἰδέ_
νίκην	noun_verb_noun_	νίκη_νικάω_νῖκος_
ἥττη	verb_verb_	ἡττάω_ἡσσάομαι_
ἄναχθ'	verb_verb_noun_	ἀνάζω_ἀνάσσω_ἄναξ_
προέχει	verb_verb_	προχέω_προέχω_
ἐποίουν	verb_verb_	ποιέω_ποιόω_
ἐξέλαβεν	verb_verb_	ἐκλαμβάνω_ἐκλάπτω_
συνείπετο	verb_verb_	συνεῖπον_συνέπομαι_
σέλας	noun_verb_	σέλας_σελάω_
Λιτὰς	adjective_noun_	λιτός_λιτή_
θεμελίων	adjective_verb_	θεμέλιος_θεμελιόω_
δόρπον	noun_noun_	δόρπον_δόρπος_
κόμας	verb_noun_	κομάω_κόμη_
Μηδείᾳ	adjective_noun_	Μήδειος_Μήδεια_
ἀκούσας	verb_verb_adjective_	ἀκούω_ἀκέω_ἀέκων_
βουλῆς	noun_noun_	βουλεύς_βουλή_
μήλων	noun_noun_	μῆλον2_μῆλον1_
ἀγρῶν	noun_noun_verb_	ἄγρα_ἀγρός_ἀγρέω_
θῶ	verb_verb_verb_	θέω_θάομαι_θάζω_
Κρίνις	noun_noun_	Κρῖνις_Κρίνις_
ἐρῶ	verb_verb_verb_verb_	ἐράομαι_ἐράω2_ἐράω1_ἐρέω_
χορείας	noun_adjective_	χορεία_χορεῖος_
Χλωρὶν	noun_noun_	χλωρίς_Χλωρίς_
εἴης	verb_verb_	εἰμί_ἐάω_
ἵ̈ει	verb_verb_	ἱέω_ἵημι_
ἔφθασεν	verb_verb_	φθάζω_φθάνω_
τέ	particle_pronoun_	τε_σύ_
Δημήτριον	adjective_noun_	Δημήτριος_Δημ́ητριος_
λεγομένης	verb_verb_verb_	λέγω3_λέγω2_λέγω1_
ἐπαναλήψει	noun_verb_	ἐπανάληψις_ἐπαναλαμβάνω_
ζυγοῦ	noun_noun_verb_verb_	ζυγόν_ζυγός_ζυγόω_ζυγέω_
κλείοντος	verb_verb_verb_	κλείω2_κλείω1_κλέω_
κολλητὰς	adjective_noun_	κολλητός_κολλητής_
χειρί	noun_noun_	χείρ_χειρίς_
παλαιοῖς	verb_adjective_	παλαιόω_παλαιός_
ῥύσι'	noun_noun_adjective_noun_	ῥῦσις_ῥύσιον_ῥύσιος_ῥύσις_
θείας	adjective_noun_	θεῖος1_θεία_
ΐδε	noun_noun_	ίδος_ιδος_
πυρῶν	noun_noun_verb_verb_noun_	πυρή_πυρά_πυράζω_πυρόω_πυρός_
πᾶσι	noun_adjective_	πᾶσις_πᾶς_
Αὔγης	noun_verb_	Αὔγη_αὐγέω_
Τρύφων	verb_noun_	τρυφάω_Τρύφων_
βλαστὸν	noun_verb_noun_	βλαστόν_βλαστάνω_βλαστός_
κεῖσ'	verb_adverb_adverb_	κεῖμαι_κεῖσε_ἐκεῖσε_
δεήσει	verb_noun_verb_	δεῖ_δέησις_δέω2_
Ῥέα	noun_noun_noun_noun_adverb_	ῥέος_ῥέον_Ῥᾶ_Ῥέα_ῥέα_
Χίμαιρα	noun_noun_	Χίμαιρα_χίμαιρα_
ὀδοῦσι	noun_noun_	ὀδών_ὀδούς_
ἁδινάων	adjective_adjective_	ἀδινός_ἁδινός_
κείνω	pronoun_verb_adjective_	ἐκεῖνος_κενόω_κεῖνος_
ὕλης	verb_noun_noun_	ὑλάω_ὗλις_ὕλη_
βιώσομαι	verb_verb_	βιώσκομαι_βιόω_
κραδίην	noun_noun_	καρδία_κραδίας_
ἀπορρήξας	verb_verb_	ἀπορρήσσω_ἀπορρήγνυμι_
Ὑπερβορέοις	noun_adjective_	Ὑπερβόρεοι_Ὑπερβόρεος_
κατακτάς	verb_adjective_	κατακτείνω_κατακτός_
προτέρου	adjective_verb_	πρότερος_προσερέσθαι_
ἀφῆκεν	verb_verb_	ἀφήκω_ἀφίημι_
σφετερισάμενον	verb_verb_	σφετερίζω_σφετερίζομαι_
πρώτοισιν	adjective_adjective_	πρότερος_πρῶτος_
δεδοκημένως	verb_verb_	δεδοκημένος_δοκέω_
ἔγχεϊ	verb_verb_noun_	ἐγχέω_ἐγχύνω_ἔγχος_
μυθήσασθαι	verb_verb_	μυθέω_μυθέομαι_
σκίφος	noun_noun_	σκίφος_ξίφος_
Καλλιμάχῳ	noun_adjective_	Καλλίμαχος_καλλίμαχος_
Λαομέδοντος	noun_noun_	Λαομέδων_λαομέδων_
ἐξιόντας	verb_verb_	ἔξειμι2_ἔξεστι_
ἀναδεξάμενος	verb_verb_	ἀναδέχομαι_ἀναδείκνυμι_
ὑποκυνῶν	verb_verb_	ὑπό-κυνάω_ὑπό-κυνέω_
ἐναντιούμενος	ἀνά-τίζ_ἀντί-ἰόομα_ἀντί-ἱέ_verb_verb_ἀντί-ἰό_	ἐν_ἐν_ἐν_ἐν-ἀντιόομαι_ἐν-ἐναντιόομαι_ἐν_
θαυμαστοί	verb_adjective_	θαυμαστόω_θαυμαστός_
ἐκδεξαμένοις	verb_verb_	ἐκδείκνυμι_ἐκδέχομαι_
Νεφέλης	noun_noun_	Νεφέλη_νεφέλη_
μικρῷ	adjective_adjective_	μικρός_σμικρός_
κνίσα	verb_noun_verb_noun_	κνίζω_κνῖσα_κνισάω_κνῖσος_
πυρῇ	noun_noun_verb_	πυρεύς_πυρή_πυράζω_
ἀνέκλασαν	ἐκ-λάζ_verb_	ἀνά_ἀνά-κλάω_
δρόμου	verb_noun_	δρομόω_δρόμος_
Ἐπειούς	adjective_adjective_	Ἐπειός_Ἐπειοί_
μῆλα	noun_noun_	μῆλον2_μῆλον1_
ὥραν	verb_noun_	ὁράω_ὥρα_
πεζῶν	adjective_noun_	πεζός_πέζα_
φαρμάκου	verb_noun_noun_	φαρμακόω_φάρμακος_φάρμακον_
καταλύσει	verb_noun_	καταλύω_κατάλυσις_
σκοπῆσαι	verb_verb_	σκοπέω_σκοπάω_
δεῖται	verb_verb_verb_	δέομαι_δέω2_δέω1_
ῥοίζω	verb_verb_noun_	ῥοίζω_ῥοιζόω_ῥοῖζος_
ἐναντιοῦνται	ἀντί-ἰόομα_ἀντί-ἱέ_ἀνά-τίζ_verb_ἀντί-ἰό_verb_	ἐν_ἐν_ἐν_ἐν-ἀντιόομαι_ἐν_ἐν-ἐναντιόομαι_
διχθά	noun_adverb_	διχθάς_διχθά_
ῥίψει	noun_verb_	ῥῖψις_ῥίπτω_
τείχει	verb_noun_	τειχέω_τεῖχος_
προδόμῳ	noun_adjective_noun_	πρόδομον_πρόδομος2_πρόδομος1_
πορφύρῃ	verb_noun_	πορφύρω_πορφύρα_
κατάγηται	verb_verb_	κατάγω_καθηγέομαι_
ἐσάωσα	verb_verb_	σαόω_σώζω_
ποντοπόροισι	adjective_adjective_	ποντοπόρος_ποντόπορος_
πολεμουμένους	verb_verb_	πολεμέω_πολεμόω_
ἰδῇ	verb_verb_	οἶδα_ἰδέω_
ποία	adjective_noun_	ποῖος_πόα_
κατεάγη	verb_verb_	κατάγνυμι_κατεάσσω_
νεὺσ'	verb_verb_verb_verb_	νέω1_νέω3_νέω_νέω2_
ῥέον	noun_verb_	ῥέον_ῥέω_
ἄρα	noun_noun_noun_noun_particle_	ἄρος_ἀρά_ἄρον_ἀρή_ἄρα_
ἐνύπνιον	noun_adjective_	ἐνύπνιον_ἐνύπνιος_
αὔξησιν	verb_noun_noun_	αὐξάνω_αὔξησις_αὖξις_
λύχνοιο	noun_noun_	λύχνος_λύχνον_
ἆσαι	verb_verb_	ἄω1_ἄω3_
Ῥέας	noun_noun_	Ῥᾶ_Ῥέα_
χολωσάμενος	verb_verb_	χολόω_χολόομαι_
δαμῆναι	verb_verb_	δαμάω_δαμάζω_
ἔζη	verb_verb_	ζέω_ζάω_
καταρχὰς	adverb_noun_	καταρχάς_καταρχή_
λείψει	verb_verb_noun_	λείπω_λείβω_λεῖψις_
θῆκ'	verb_noun_	τίθημι_θήκη_
ἔναιον	verb_verb_	ναίω2_ναίω1_
ἀπιόντων	verb_verb_	ἄπειμι1_ἄπειμι2_
κατέδονται	verb_verb_	κατεσθίω_κατέδω_
ἄνω	adverb_adjective_verb_	ἄνω2_ἄνοος_ἄνω1_
ἀναιροῦσα	verb_verb_	ἀνιερόω_ἀναιρέω_
ῥοάς	noun_noun_	ῥοή_ῥοάς_
μακάρων	noun_adjective_	μάκαρ_μάκαρος_
κακῶ	verb_adjective_verb_	κακόω_κακός_κακάζω_
μόχθω	verb_noun_	μοχθόω_μόχθος_
ναίειν	verb_verb_	ναίω1_ναίω2_
δαμάσω	verb_verb_	δαμάω_δαμάζω_
λόγους	verb_noun_	λογόω_λόγος_
Ἰλίῳ	adjective_noun_noun_adjective_	Ἴλιοσλιος_Ἴλιον_Ἴλιος_Ἴλι_
Ἅδου	noun_verb_verb_	ἅδος_ἁνδάνω_ἥδομαι_
παριστῶσιν	verb_verb_	παριστάω_παρίστημι_
ῥήξαι	verb_verb_	ῥήγνυμι_ῥήσσω_
φυλάσσετε	verb_verb_	φυλάσσω_φυλάζω_
ἔπειτ'	verb_adverb_	ἔπειμι2_ἔπειτα_
ἔλλη	verb_verb_	ἐν-λάω2_ἐν-λάω1_
Κολώνη	noun_noun_	κολώνη_Κολώνη_
νείκεσσ'	noun_verb_noun_	νεῖκος_νεικέω_νει_
σκυλεύσας	verb_verb_verb_verb_	σκυλεύω_σκύλλω_σκυλόω_σκυλάω_
Θυμβρίου	noun_noun_	Θύμβριον_Θύμβριος_
ἐπιπολῆς	noun_verb_	ἐπιπολή_ἐπιπολάζω_
Ζῆν	verb_verb_noun_	ζάω_ζέω_Ζεύς_
παραγωγῇ	noun_noun_	παραγωγεύς_παραγωγή_
ἄρ᾽	verb_noun_verb_particle_	ἀρόω_ἄρον_αἴρω_ἄρα_
ὁμοίως	adjective_adjective_verb_	ὅμοιος_ὁμοῖος_ὁμοιόω_
ἤρτηντο	verb_verb_	ἀρτέομαι_ἀρτάω_
χρᾶται	verb_verb_verb_	χράω2_χράομαι_χραύω_
ἁραιότερα	adjective_adjective_	ἀραῖος_ἀραιός_
πέλας	adverb_verb_	πέλας_πελάω_
φονοῖο	verb_verb_noun_	φονάω_φονόω_φονός_
Χρύσιππον	noun_noun_	Χρύσιππος_Χρυσίππος_
ἅμ	preposition_preposition_	ἐν_ἀνά_
Πάριν	noun_verb_	Πάρις_πάρειμι2_
κύδους	noun_noun_	κῦδος_κύδος_
μεσονύκτιον	adjective_noun_	μεσονύκτιος_μεσονύκτιον_
ἐναντιοῦται	verb_ἀντί-ἰόομα_verb_ἀντί-ἰό_	ἐν-ἀντιόομαι_ἐν_ἐν-ἐναντιόομαι_ἐν_
λέγοιμεν	verb_verb_verb_	λέγω1_λέγω2_λέγω3_
πλείου	verb_adjective_	πλέω_πλέως_
ἰῶ	verb_verb_noun_noun_verb_	ἰόω_ἰάζω_ἰός2_ἰός1_ἰάομαι_
Θυέστ'	noun_noun_	θυέστης_Θυέστης_
ἀγορῇ	noun_verb_verb_	ἀγορά_ἀγοράομαι_ἀγοράζω_
λῶ	verb_verb_verb_	λάζω_λάω2_λάω1_
οἴνου	noun_verb_noun_	οἶνος_οἰνόω_οἶνον_
ἀνδρί	noun_noun_	ἀνήρ_ἀνδρίς_
ἐξιὼν	verb_verb_	ἔξεστι_ἔξειμι2_
γλήνη	noun_noun_	γλήνη_γλῆνος_
σφ'	pronoun_adjective_verb_	σφεῖς_σφός_ἕπομαι_
ναυπηγοῦ	verb_noun_	ναυπηγέω_ναυπηγός_
πεδίοι	verb_verb_	πεδάω_μέτειμι2_
ἐνεργῆται	verb_verb_	ἐνεργέω_ἐνεργάζομαι_
Κύκνος	noun_noun_	κύκνος_Κύκνος_
ἀναιρουμένους	verb_verb_	ἀνιερόω_ἀναιρέω_
πιστὰ	adjective_adjective_noun_	πιστός2_πιστός1_πιστόν_
Μυσοὺς	noun_adjective_	Μυσός_μυσός_
Ἰορδάνου	noun_adjective_	Ἰορδάνης_Ἰόρδανος_
στάδιον	adjective_noun_	στάδιος_στάδιον_
ὁμοιΐου	adjective_adjective_	ὅμοιος_ὁμοίιος_
προδιασυνίστησι	διά-συνιστά_διά-συνίστημ_	πρό_πρό_
βαρβάρου	verb_adjective_verb_	βαρβαρόω_βάρβαρος_βαρβαρόομαι_
πυκνότερον	adjective_adjective_	πυκνός_πυκνος_
πᾶσιν	noun_adjective_	πᾶσις_πᾶς_
Ἀχαιῶν	adjective_noun_	Ἀχαιός_ἀχαιά_
ζώοντ'	verb_verb_	ζώω_ζάω_
μολπῇ	noun_verb_	μολπή_μολπάζω_
οὐλῆς	noun_verb_	οὐλή_οὐλέω_
ἀνίησι	verb_verb_	ἄνειμι_ἀνίημι_
ζῷα	noun_noun_	ζώιον_ζῷον_
πεδίον	noun_verb_	πεδίον_πεδάω_
τάχους	adjective_noun_	ταχύς_τάχος_
πλάνης	verb_noun_noun_	πλανάω_πλάνη_πλάνης_
πεῖσα	noun_verb_	πεῖσα_πείθω_
πόθι	adverb_adverb_	πόθι_ποθι_
φυγάς	noun_noun_	φυγή_φυγάς_
βόα	noun_noun_verb_	βόα_βοῦς_βοάω_
βιβάσθω	verb_verb_	βιβάσθω_βιβάω_
ναίουσιν	verb_verb_	ναίω2_ναίω1_
Ἐπειοὺς	adjective_adjective_	Ἐπειοί_Ἐπειός_
δεσπότης	verb_noun_	δεσποτέω_δεσπότης_
πολεμούμενοι	verb_verb_	πολεμέω_πολεμόω_
καθεζομένους	verb_verb_	κατά-καθέζομαι_κατά-ἕζομαι_
ἐπίκλησιν	verb_noun_	ἐπικλάω_ἐπίκλησις_
ζυγῷ	noun_noun_	ζυγός_ζυγόν_
ἔκτισαν	verb_verb_	κτίζω_ἐκτίνω_
ἐνέδη	verb_verb_	ἐνδέω2_ἐνδέω1_
χρυσοῦν	verb_adjective_	χρυσόω_χρύσεος_
ἠράσθην	verb_verb_verb_verb_verb_verb_verb_verb_verb_	ἐρέομαι_ἐράω2_αἴρω_ἀράζω_ἐράομαι_ἀρέομαι_ἐρέω_ἔραμαι_ἀράομαι_
ὁδῷ	noun_noun_verb_	ὁδός2_ὁδός1_ὁδάω_
ἡνία	noun_noun_noun_	ἡνία1_ἡνίον_ἡνία2_
Ἕκτορ	noun_noun_	ἕκτωρ_Ἕκτωρ_
Αἰτίω	verb_adjective_	αἰτέω_αἴτιος_
χεῖσθαι	verb_verb_	χάω_χέω_
Ἀρίσταρχος	noun_noun_	Ἀρίσταρχος_ἀρίσταρχος_
ξηρὰν	adjective_noun_	ξηρός_ξηρά_
ὅρια	adjective_noun_	ὅριος_ὅριον_
ἀνακοινοῦσιν	verb_verb_	ἀνακοινόω_ἀνακοινέω_
ἐκρέμω	verb_verb_	κρεμάννυμι_κρεμόω_
ἀνωτέρω	adverb_adjective_	ἄνω2_ἀνώτερος_
ἀρίστῳ	noun_adjective_	ἄριστον_ἄριστος_
ἔρεξε	verb_verb_	ῥέζω_ἐρέσσω_
Διόσκουροι	noun_noun_	Διόσκοροι_Διόσκουροι_
φάνη	verb_verb_	φανάω_φαίνω_
ᾠήθησάν	verb_verb_	οἰάω_οἴομαι_
μεριμνᾶν	noun_verb_	μέριμνα_μεριμνάω_
ἄλλως	adverb_pronoun_	ἄλλως_ἄλλος_
ἄγων	verb_verb_	ἄγω_ἀγάω_
σύριγξι	noun_noun_	σύριγξις_σῦριγξ_
ἰθὺς	adverb_adjective_	ἰθύς1_εὐθύς1_
πὰρὰ	preposition_noun_	παρά_πῆρος_
θύεται	verb_verb_	θύω1_θύω2_
ὠρῶν	verb_noun_noun_	ὠρέω_ὦρος_ὤρα_
Ἀήτου	noun_adjective_	ἀήτης_ἄητος_
ἀνωτάτω	adverb_adjective_	ἄνω2_ἀνώτατος_
στρατιὰς	noun_noun_	στρατία_στρατιά_
Κύπριοι	adjective_adjective_	κύπριος_Κύπριος_
βιβάσθων	verb_verb_	βιβάσθω_βιβάω_
Ἐφύρας	noun_noun_verb_	Ἔφυρα_Ἐφύρα_φυράω_
μειλιχίῃ	noun_adjective_	μειλιχία_μειλίχιος_
ἐπιθέτῳ	adjective_noun_	ἐπίθετος_ἐπίθετον_
δεξὶ'	adjective_noun_	δεξιός_δεξιά_
σκληροῖς	adjective_verb_	σκληρός_σκληρόω_
ῥηθήσεται	verb_verb_	ἐρῶ_ῥέομαι_
ἀρκτέον	adjective_adjective_	ἀρκτέον_ἀρκτέος_
ξηρά	adjective_noun_	ξηρός_ξηρά_
νεοίατο	verb_verb_verb_verb_	νέω_νέομαι_νέω3_νεόω_
συρρήσσων	verb_verb_	συρρήσσω_συρράσσω_
ἐκτείνομεν	verb_verb_	ἐκτείνω_κτείνω_
δίου	verb_adjective_verb_	δίεμαι_δῖος_δίω_
Τιτάνων	noun_noun_noun_	Τιτάν_Τίτανος_τίτανος_
πρεσβεία	noun_noun_	πρέσβεια_πρεσβεία_
καλοῦ	adjective_verb_	καλός_καλέω_
λεγομένην	verb_verb_verb_	λέγω1_λέγω3_λέγω2_
Μέσην	adjective_noun_noun_noun_	μέσος_μέση_Μέση_μέσης_
ἆρά	noun_verb_	ἆρα_αἴρω_
τίνές	pronoun_irregular_verb_	τις_τίς_τίνω_
πένθεϊ	verb_noun_	πενθέω_πένθος_
πρόβατον	verb_noun_	προβαίνω_πρόβατον_
ἤρκει	verb_verb_	ἀρκέω_αἴρω_
ἀλαλαγμὸν	noun_noun_	ἀλαλαγμός_ἀλαλαγή_
λέγει	verb_verb_verb_	λέγω2_λέγω3_λέγω1_
πόλιας	noun_noun_	πόλις_πόόλις_
χρῶμαι	verb_verb_verb_verb_	χράω1_χράομαι_χράω2_χραύω_
πιθοίμεθα	verb_verb_verb_	πιθέω_πιθόω_πείθω_
πτῶ	verb_verb_	πέτομαι_πτάζω_
στίχοι	noun_verb_	στίχος_στείχω_
πώς	adverb_particle_	πῶς2_πως_
μικρότερος	adjective_adjective_	μικρός_σμικρός_
φιλίαν	adjective_noun_	φίλιος_φιλία_
ἀπολελυμένως	adverb_verb_	ἀπολελυμένως_ἀπολύω_
ἐλίσσοντο	verb_verb_verb_	ἐλίσσω_ἑλίσσω_λίσσομαι_
λίπ'	adverb_verb_	λίπα_λείπω_
βοᾶ	verb_adjective_noun_	βοάω_βόειος_βοείη_
ἐτιμήθη	verb_verb_	τιμάω_τιμέω_
μορφῇ	verb_noun_verb_	μορφάω_μορφή_μορφάζω_
ναίων	verb_verb_adjective_	ναίω1_ναίω2_νήιος_
πρώτου	adjective_adjective_	πρότερος_πρῶτος_
φυλάσσω	verb_verb_	φυλάσσω_φυλάζω_
ἱράων	adjective_adjective_	ἱρός_ἱερός_
ἐφάνη	verb_verb_	φανάω_φαίνω_
πωλεῖταί	verb_verb_	πωλέω_πωλέομαι_
ἐγήρασεν	verb_verb_	γηράω_γηράσκω_
λιπεῖν	verb_verb_	λείπω_λιπάω_
ποδῶν	noun_verb_	πούς_ποδόω_
Λαπιθάων	noun_noun_	Λαπίθης_Λαπίθαι_
μέλας	adjective_noun_	μέλας_μέλη_
προστασσομένων	verb_verb_	προστάσσω_προσστάζω_
νιφέμεν	verb_verb_	νίφω_νίζω_
σοφῶν	verb_adjective_	σοφόω_σοφός_
ὀρθῶς	verb_adjective_	ὀρθόω_ὀρθός_
παρηρτῆσθαι	verb_verb_	παραρτάομαι_παραρτέομαι_
αἰθούσῆς	noun_verb_	αἴθουσα_αἴθω_
φυλάξει	verb_noun_verb_	φυλάζω_φύλαξις_φυλάσσω_
κάτω	verb_adjective_adverb_	κατόω_κάτος_κάτω_
πρόστασσε	verb_verb_	προσστάζω_προστάσσω_
πάντ'	adjective_adverb_	πᾶς_πάντῃ_
Ἀθηναίην	adjective_noun_	Ἀθηναῖος_Ἀθήνη_
ἀποσταλῆναι	verb_verb_	ἀποστέλλω_ἀποσταλάω_
περισπωμένως	verb_adverb_	περισπάω_περισπωμένως_
ἐπίσχοις	verb_verb_	ἐπώχατο_ἐπίσχω_
ἡμᾶς	adjective_pronoun_	ἡμός_ἐγώ_
βασίλεια	noun_noun_	βασίλεια_βασίλειον_
Σκῶλόν	noun_noun_noun_	σκῶλος_Σκῶλος_σκῶλον_
ὅλα	adjective_verb_adjective_	ὅλοξ_ὁλάω_ὅλος_
νοητέον	adjective_adjective_	νοητέος_νοητέον_
θάλψεις	noun_verb_	θάλψις_θάλπω_
λιπαρᾶς	adjective_adjective_	λιπαρής_λιπαρός_
μεταβολῇ	noun_noun_	μεταβολεύς_μεταβολή_
ἄροσιν	noun_verb_	ἄροσις_ἀρόω_
ἐπαγωγῇ	noun_noun_	ἐπαγωγή_ἐπαγωγεύς_
μυηθῆναι	verb_verb_	μυέω_μυάω_
ἐπίθετα	noun_adjective_	ἐπίθετον_ἐπίθετος_
ποτοῦ	verb_verb_verb_noun_adjective_	ποτέομαι_ποτάομαι_προσίημι_ποτόν_ποτός_
Πολυμνίας	noun_noun_	Πολυμνίη_Πολύμνια_
εἴδομεν	verb_verb_	οἶδα_εἶδον_
σεμνῶν	noun_adjective_verb_	σεμνόν_σεμνός_σεμνόω_
ἐχθρῶν	noun_noun_adjective_	ἔχθρη_ἔχθρα_ἐχθρός_
τίσεις	verb_verb_verb_noun_	τίω_τίνω_τίζω_τίσις_
αὔω	noun_verb_adjective_verb_	αὔως_αὔω1_αὖος_αὔω2_
σταδίων	adjective_noun_	στάδιος_στάδιον_
ποιητῶν	noun_adjective_	ποιητής_ποιητός_
ἀργυρόπεζα	noun_adjective_	ἀργυρόπεζα_ἀργυρόπεζος_
κατεδηδώς	verb_verb_	κατέδω_κατεσθίω_
Σώκου	noun_noun_	Σῶκος_σῶκος_
χρώμενοι	verb_verb_verb_verb_	χράω2_χραύω_χράομαι_χράω1_
συνιστάμενα	verb_verb_	συνιστάω_συνίστημι_
παρειάων	noun_noun_noun_	παρείας_παρείης_παρειά_
ποῦ	noun_adverb_	ποῦ_πού_
ἐπέβη	verb_verb_	ἐπιβαίνω_πέσσω_
ἀπιέναι	verb_verb_	ἀφίημι_ἄπειμι2_
κὰτα	adjective_preposition_	κάτος_κατά_
τῆλ᾽	adverb_noun_	τῆλε_τήλη_
δαὶθ'	noun_noun_	δαίτη_δαίτης_
ἁπλῶ	adjective_adjective_verb_	ἁπλόος_ἁπλός_ἁπλόω_
ἴ̈σως	adjective_adverb_verb_	ἴσος_ἴσως_ἰσόω_
ὑπακούσῃ	noun_verb_	ὑπάκουσις_ὑπακούω_
στάσει	verb_verb_noun_	ἵστημι_στάζω_στάσις_
βοᾶν	verb_noun_noun_	βοάω_βοή_βόα_
Δήμω	noun_noun_	Δῆμος_δῆμος_
δόξα	noun_verb_	δόξα_δοκέω_
ἀσθενούσαις	verb_verb_	ἀσθενόω_ἀσθενέω_
ξένοι	noun_adjective_	ξένος1_ξένος2_
ἀκούσια	adjective_adjective_	ἀεκούσιος_ἀκούσιος_
ἐπιτελεῖ	verb_verb_adjective_	ἐπιτελέω_ἐπιτέλλω_ἐπιτελής_
πολυτελεῖς	verb_adjective_	πολυτελέω_πολυτελής_
ἀνδρείως	adjective_verb_	ἀνδρεῖος_ἀνδρειόω_
ἄκρον	adjective_noun_noun_	ἄκρος_ἄκρον_ἄκρων_
ἐγχωρίων	verb_adjective_	ἐγχωρέω_ἐγχώριος_
ἐρρωμένας	verb_adjective_	ῥώννυμι_ἐρρωμένος_
παροῦσα	verb_verb_	παρόω_πάρειμι1_
Πηλείδῃ	noun_noun_	Πηλείδης_Πηλεύς_
Λάρισαν	noun_noun_	Λάρισα_Λάρισσα_
κοιλοτέρων	adjective_adjective_	κοῖλος_κόιλος_
κόλον	noun_adjective_	κόλον_κόλος_
ξενίαν	adjective_noun_	ξένιος_ξενία_
λαῶν	noun_noun_	λαός_λᾶας_
ἄϊον	verb_verb_	ἀίω1_ἀίω2_
αὐξήσει	noun_verb_	αὔξησις_αὐξάνω_
ἔδησέν	verb_verb_	δέω2_δέω1_
ἑπτὰ	noun_numeral_	ἑπτάς_ἑπτά_
Λοκροὶ	noun_adjective_	Λοκροί_Λοκρός_
Μέροπος	noun_noun_	μέροψ_Μέροψ_
δέρας	noun_noun_	δέρος_δειρή_
εἰκῶν	verb_noun_	εἰκάζω_εἰκών_
αἴθ'	adverb_conjunction_exclamation_	εἴτε_αἴθε_εἴθε_
σῶν	verb_adjective_noun_adjective_	σέω_σῶς_σής_σός_
ἦρχ'	verb_verb_	ἄρχω_αἴρω_
ἀταράχως	adjective_adjective_	ἀτάρακτος_ἀτάραχος_
ἰ̈ούς	noun_noun_	ἰός2_ἰός1_
δαῒ	particle_noun_	δαί_δαίς1_
διχῶς	adverb_verb_	διχῶς_διχόω_
συνέχων	verb_verb_	συνόχωκα_συγχώννυμι_
ἀτυζόμενοι	verb_verb_	ἀτύζομαι_ἀτύζω_
διαμπερές	adjective_adverb_	διαμπερής_διαμπερές_
θήλει	verb_adjective_verb_	θάλλω_θῆλυς_θηλέω_
μελήσει	verb_verb_	μέλω_ἐπιμελέομαι_
διϊστᾶσι	verb_verb_	διιστάω_διίστημι_
ἐρῶντα	verb_verb_	ἐράω2_ἐράω1_
πυρὰ	noun_noun_	πυρή_πυρά_
ἴ̈δῃ	noun_verb_	ἴδη_εἶδον_
νεωτέροις	adjective_adjective_	νεώτερος_νέος_
ἔθει	verb_verb_noun_	θέω_ἔθω_ἔθος_
πρέπον	noun_verb_	πρέπων_πρέπω_
παραὶ	preposition_adjective_	παρά_πηρός_
ἐναντιοῦσθαι	verb_ἀντί-ἰό_verb_ἀντί-ἰόομα_	ἐν-ἀντιόομαι_ἐν_ἐν-ἐναντιόομαι_ἐν_
Μούσαις	noun_noun_	Μοῦσαι_Μοῦσα_
πεπαιδευμένως	verb_adverb_	παιδεύω_πεπαιδευμένως_
Ἴδῃς	noun_noun_verb_	Ἴδη_ἴδη_εἶδον_
ὅρκων	verb_noun_	ὁρκόω_ὅρκος_
Κυπάρισσος	noun_noun_	κυπάρισσος_Κυπάρισσος_
ἀσθενῆς	adjective_verb_	ἀσθενής_ἀσθενέω_
Ἀσίᾳ	adjective_noun_adjective_noun_	Ἄσιος_Ἀσία_ἄσιος_Ἀσίας_
Σχοῖνόν	noun_noun_	σχοῖνος_Σχοῖνος_
θοῶς	adjective_verb_	θοός_θοόω_
Ἄρην	verb_noun_noun_	ἀράω2_ἄρος_Ἄρης_
Θάλπιος	noun_noun_	Θάλπιος_θάλπος_
διείρεο	verb_verb_	διείρω_διείρομαι_
ποιητήν	adjective_noun_	ποιητός_ποιητής_
πυλῶν	noun_verb_	πύλη_πυλόω_
ἀπόφασις	noun_noun_	ἀπόφασις1_ἀπόφασις2_
ὁρμηθέντες	verb_verb_	ὁρμέω_ὁρμάω_
παραδέξαιτο	verb_verb_	παραδείκνυμι_παραδέχομαι_
σανίδων	noun_verb_	σανίς_σανιδόω_
ζυγοστατῶν	noun_verb_	ζυγοστάτης_ζυγοστατέω_
πήξας	verb_verb_	πήσσω_πήγνυμι_
ποιοῦνται	verb_verb_	ποιόω_ποιέω_
σκοπέλων	noun_noun_	σκόπελον_σκόπελος_
θάρσει	verb_noun_	θαρσέω_θάρσος_
φονεῦσαι	verb_verb_verb_	φονάω_φονεύω_φονόω_
καταδῦναι	verb_verb_	καταδύω_καταδύνω_
λευκόν	noun_adjective_	λευκόν_λευκός_
Ἴλιον	noun_noun_adjective_adjective_	Ἴλιον_Ἴλιος_Ἴλιοσλιος_Ἴλι_
θυμιᾶσαι	verb_verb_	θυμιάζω_θυμιάω_
ἁγρίων	adjective_verb_verb_verb_	ἄγριος_ἀγριόω_ἀγριάω_ἀγρέω_
οἰκείων	adjective_verb_verb_verb_	οἰκεῖος_οἰκείω_οἰκειόω_οἰκέω_
Ἰάς	noun_noun_	ἰά_Ἰάς_
Ἐλευσῖνι	noun_adverb_	Ἐλευσίς_Ἐλευσῖνι_
φίλου	adjective_verb_	φίλος_φιλόω_
τεύξεται	verb_verb_	τεύχω_τυγχάνω_
αἰτίων	adjective_verb_	αἴτιος_αἰτέω_
ἀναγκαῖον	noun_adjective_	ἀναγκαῖον_ἀναγκαῖος_
κείμεναι	verb_verb_	κέω_κεῖμαι_
ἕν	noun_verb_	εἷς_ἵημι_
κεῖσθαι	verb_verb_	κέω_κεῖμαι_
θεωρήσῃ	verb_noun_	θεωρέω_θεώρησις_
σαώσῃς	verb_verb_	σαόω_σώζω_
μελαίνης	adjective_noun_	μέλας_μέλαινα_
διατάξει	noun_verb_verb_	διάταξις_διατάσσω_διατήκω_
ἀκέουσα	adjective_verb_	ἀκέων_ἀκέω_
προσεδόκησεν	verb_verb_	προσδοκάω_προσδοκέω_
πυθόμην	verb_verb_	πυνθάνομαι_πύθω_
τελετήν	noun_noun_	τελετής_τελετή_
σέο	pronoun_verb_	σύ_σέω_
ταυρείην	adjective_noun_	ταύρειος_ταυρεία_
φύλλων	noun_verb_	φύλλον_φυλλόω_
ἑλῶν	noun_noun_verb_	ἕλη_ἕλος_αἱρέω_
σίαλόν	noun_noun_	σίαλος_σίαλον_
ἔγρετο	verb_verb_	ἐγείρω_ἔγρω_
δέονται	verb_verb_verb_	δέω2_δέομαι_δέω1_
ἐκείνω	verb_pronoun_	κενόω_ἐκεῖνος_
δύναιτ'	verb_verb_	δύω2_δύναμαι_
νοῦν	noun_verb_verb_verb_verb_	νόος_νέω1_νέω3_νέω_νέω2_
χαλκείῃ	noun_adjective_	χαλκεία_χάλκειος_
ἄρχων	verb_noun_	ἄρχω_ἄρχων_
πρωτέων	adjective_adjective_noun_adjective_	πρωτός_πρότερος_πρωτεύς_πρῶτος_
ἀφίξεσθαι	verb_verb_	ἀφικνέομαι_ἀφίζω_
ἐξέλασ'	verb_verb_noun_	ἐξαιρέω_ἐξελαύνω_ἐξέλασις_
κατεδέξαντο	verb_verb_	καταδέχομαι_καταδείκνυμι_
μήτις	noun_pronoun_	μῆτις_μήτις_
Ἔφυραν	verb_noun_	φύρω_Ἔφυρα_
τετεύχαται	verb_verb_	τεύχω_τυγχάνω_
ἀναίρει	verb_verb_	ἀναίρω_ἀναιρέω_
Ἀριστονίκου	noun_adjective_	Ἀριστόνικος_ἀριστόνικος_
ἐπιθέματα	noun_noun_	ἐπίθεμα_ἐπίθημα_
ἐκρέμασε	verb_verb_	κρεμάζω_κρεμάννυμι_
ἐσκέδασ'	verb_verb_	σκεδάννυμι_σκεδάω_
Ἀψευδής	adjective_noun_	ἀψευδής_Ἀψευδής_
οἴκω	verb_noun_	ἔοικα_οἶκος_
Ἰνδικῇ	verb_adjective_	ἰνδικάζω_Ἰνδικός_
ὕστατον	adjective_adjective_	ὕστερος_ὕστατος_
νείκει	verb_noun_noun_	νεικέω_νεῖκος_νει_
πυθόμενον	verb_verb_	πυνθάνομαι_πύθω_
βρίσαντες	verb_verb_	βρίθω_βρίζω_
νηός	noun_noun_	ναῦς_ναός_
νώτου	noun_noun_	νῶτος_νῶτον_
μεριμνῶν	verb_noun_	μεριμνάω_μέριμνα_
Αἰτωλοῖς	adjective_noun_	Αἰτωλός_Αἰτωλοί_
Χάρης	verb_noun_	χαίρω_Χάρης_
γλαῦκε	noun_noun_	γλαύξ_γλαῦκος_
λήσει	verb_noun_	λανθάνω_λῆσις_
ἐπονεῖτο	verb_verb_	πονέομαι_πονέω_
κολεοῖο	noun_noun_	κολεός_κολεόν_
ὄσσα	noun_noun_	ὄσσε_ὄσσα_
χρειῶ	noun_verb_	χρεώ_χρείζω_
ἀμετάτρεπτος	adjective_adjective_	ἀμετάτρεπτος_ἀμετάστροφος_
φοιτῷσιν	verb_verb_	φοιτάζω_φοιτάω_
οὐδαμῶς	adverb_adjective_	οὐδαμῶς_οὐδαμός_
ὄργανα	noun_verb_adjective_	ὄργανον_ὀργαίνω_ὄργανος_
λάαν	verb_verb_	λάω1_λάω2_
λέγει	verb_verb_verb_	λέγω2_λέγω1_λέγω3_
κέοιτο	verb_verb_	κέω_κεῖμαι_
ἔφθασε	verb_verb_	φθάζω_φθάνω_
συμφορᾷ	verb_noun_	συμφοράζω_συμφορά_
ἄλλῃ	pronoun_adverb_	ἄλλος_ἄλλῃ_
φυλάξαιτο	verb_verb_	φυλάζω_φυλάσσω_
ποτ'	preposition_noun_adjective_noun_particle_	πρός_ποτόν_ποτός_ποτή_ποτέ_
κηρεσσιφορήτους	adjective_adjective_	κηρεσσιφόρητος_Κηρεσσιφόρητος_
συνυπακοῦσαι	ὑπό-ἀκέ_verb_	σύν_σύν-ὑπακούω_
ἀνηρημένων	verb_verb_verb_verb_verb_	ἀνά-ἐρέομαι_ἀνά-ἀράω2_ἀνά-ἀρέομαι_ἀνά-ἐρέω_ἀνά-ἐράομαι_
ἄμμος	noun_adjective_	ἄμμος_ἁμός1_
φαρμακ'	noun_noun_	φαρμακίς_φαρμακός_
ἑπτά	noun_numeral_	ἑπτάς_ἑπτά_
εἶς	preposition_verb_verb_	εἰς_εἶμι_εἰμί_
πειρᾶς	verb_verb_noun_	πειράζω_πειράω_πειρά_
καθίστα	verb_verb_	καθιστάω_καθίστημι_
ἀγρώστην	noun_noun_	ἀγρώστης_ἀγρότης_
Χαλκίδα	noun_noun_	Χαλκίς_χαλκίς_
τιμήσει	verb_verb_noun_	τιμάω_τιμέω_τίμησις_
ἐπορεύετο	verb_verb_	ἐφορεύω_πορεύω_
ζυγόν	noun_noun_	ζυγός_ζυγόν_
Ἄρειον	noun_adjective_adjective_noun_adjective_	Ἀρείων_ἄρειος_ἀρείων_Ἀρεῖος_Ἄρειος_
δοκοῦν	verb_verb_noun_	δοκόω_δοκέω_δοκώ_
ἐπιθυμίας	noun_verb_	ἐπιθυμία_ἐπιθυμιάω_
Διοσκούρους	noun_noun_	Διόσκοροι_Διόσκουροι_
πολυκοιρανίη	noun_noun_	πολυκοιρανίη_πολυκοιρανία_
κείνου	adjective_verb_pronoun_	κεῖνος_κενόω_ἐκεῖνος_
λέγοιμ'	verb_verb_verb_	λέγω3_λέγω1_λέγω2_
πρώτῳ	adjective_adjective_	πρῶτος_πρότερος_
ἐψηφίσαντο	verb_verb_	ψηφίζομαι_ψηφίζω_
λέγε	verb_verb_verb_adjective_	λέγω2_λέγω3_λέγω1_λέγος_
καρδία	noun_verb_	καρδία_καρδιάω_
ἀστέρων	verb_noun_	ἀστερόω_ἀστήρ_
Ἀραβία	adjective_noun_adjective_	Ἄραψ_Ἀραβία_Ἀράβιος_
φεύξονται	verb_verb_	φεύγω_φεύζω_
πεδίου	noun_noun_	πεδίον_πέδιον_
βοῆς	noun_noun_adjective_verb_	βοή_βοεύς_βόειος_βοάω_
ἀμβροσία	noun_adjective_	ἀμβροσίη_ἀμβρόσιος_
ψύχους	noun_verb_	ψῦχος_ψυχόω_
φωτός	noun_noun_	φάος_φώς_
ὀργάνοις	noun_adjective_	ὄργανον_ὄργανος_
ἔπηξεν	verb_verb_verb_	ἐφήκω_πήγνυμι_πήσσω_
ὁρμήσαντες	verb_verb_	ὁρμάω_ὁρμέω_
ἰδίοις	adjective_verb_verb_	ἴδιος_ἰδέω_ἰδίω_
καλῆς	verb_adjective_	καλέω_καλός_
ὑπέσχετο	verb_verb_	ὑπισχνέομαι_ὑπέχω_
Νότου	noun_noun_	Νότος_νότος_
φυλαχθήσεται	verb_verb_	φυλάζω_φυλάσσω_
πυρσοί	noun_adjective_	πυρσός_πυρρός_
συνδεῖται	verb_verb_	συνδέω_συνδέομαι_
Ἀριστάρχῳ	noun_noun_	Ἀρίσταρχος_ἀρίσταρχος_
ναὶ	adverb_noun_	ναί_ναῦς_
νοῶσιν	verb_verb_	νοόω_νοέω_
ἀπάτη	noun_verb_	ἀπάτη_ἀπατάω_
Ἀρήϊος	adjective_adjective_adjective_	Ἀρήιος_Ἄρης_ἄρειος_
κλείεσθαι	verb_verb_verb_	κλέω_κλείω1_κλείω2_
Ἴδην	noun_noun_noun_noun_	ἶδος_Ἴδης_ἴδη_Ἴδη_
πίθω	verb_verb_noun_	πιθόω_πείθω_πίθος_
πικροῦ	adjective_verb_	πικρός_πικρόω_
προχείρου	noun_adjective_	πρόχειρον_πρόχειρος_
ἐμοῖσιν	adjective_verb_	ἐμός_ἐμέω_
νεώς	noun_noun_noun_	ναῦς_ναός_νεώς_
Κλυταιμνήστρη	noun_noun_	Κλυταιμνήστρα_Κλυταιμνήστρη_
Μέλας	noun_adjective_noun_noun_	μέλη_μέλας_Μέλης_Μέλας_
ἡττηθῆναι	verb_verb_	ἡττάω_ἡσσάομαι_
Κυβέλοις	noun_noun_	Κύβελον_Κύβελα_
οἴη	verb_noun_adjective_	οἰάω_οἴη_οἶος_
γυναικῶν	noun_verb_	γυνή_γυναικόω_
πεδίοιο	noun_verb_noun_	πεδίον_πεδάω_πέδιον_
διωρίζετο	verb_verb_verb_	διά-ὡρίζω_διά-ὁρίζω_διά-ὠρίζω_
Ἱπποδαμείας	noun_noun_	Ἱπποδαμείη_Ἱπποδάμεια_
τυχὸν	verb_adverb_	τυγχάνω_τυχόν_
κορύνη	verb_noun_	κορυνάω_κορύνη_
αὐτάρκης	verb_adjective_	αὐταρκέω_αὐτάρκης_
ἀγαθοῦ	adjective_verb_	ἀγαθός_ἀγαθόω_
ἀναίρων	verb_verb_	ἀναίρω_ἀνιερόω_
Πρωτέας	noun_noun_	πρωτεύς_Πρωτέας_
Μουσάων	noun_noun_	Μοῦσαι_Μοῦσα_
πόθεν	particle_adverb_verb_	ποθεν_πόθεν_πίνω_
δαΐς	noun_noun_	δαίς3_δαίς1_
ἔβραχε	verb_verb_	βράσσω_βραχεῖν_
ἀνάπλουν	verb_verb_noun_	ἀναπλέω_ἀναπλόω_ἀνάπλοος_
πάλοις	noun_noun_verb_	πάλος_πᾶλος_πάλλω_
Μοῦσα	noun_noun_	Μοῦσα_Μοῦσαι_
πίθων	verb_noun_noun_	πιθόω_πίθων_πίθος_
πτῶσιν	noun_verb_	πτῶσις_πτάζω_
Ἡφαιστότευκτον	adjective_adjective_	Ἡφαιστότευκτος_ἡφαιστότευκτος_
ἐπιθυμίαν	noun_verb_	ἐπιθυμία_ἐπιθυμιάω_
μηρ'	noun_noun_	μηρίς_μηρός_
χρώμενον	verb_verb_verb_verb_	χραύω_χράομαι_χράω1_χράω2_
οἴνοιο	noun_noun_	οἶνος_οἶνον_
Ἀλέου	noun_noun_	Ἀλέος_Ἄλεος_
τροφέοντα	verb_verb_	τροφέω_τρέφω_
τέλεσι	noun_noun_	τέλος_τέλεσις_
ποιοῦντα	verb_verb_	ποιόω_ποιέω_
Πύλου	noun_noun_verb_noun_	πύλος_Πύλος_πυλόω_Πύλης_
ἔσχ'	verb_verb_	ἔχω_εἰμί_
κατάξας	verb_verb_verb_	κατάγω_κατάγνυμι_κατάσσω_
παύσει	noun_verb_	παῦσις_παύω_
φυτὸν	adjective_noun_	φυτός_φυτόν_
Ἶρι	noun_noun_	Ἶρις_ἶρις_
πλεονάσει	verb_noun_	πλεονάζω_πλεόνασις_
Φοινίκη	noun_noun_	φοινίκη_Φοινίκη_
ὥρμης	verb_verb_	ὁρμέω_ὁρμάω_
νέων	verb_verb_verb_verb_adjective_verb_	νεάω_νέω3_νέω1_νέω_νέος_νέω2_
χαλκείῳ	adjective_noun_	χάλκειος_χαλκεῖον_
Ἕκτωρ	noun_noun_	ἕκτωρ_Ἕκτωρ_
Μελανίππου	noun_adjective_	Μελάνιππος_μελάνιππος_
Νάστου	noun_noun_	Νάστης_νάστης_
Αἰνόπαρις	noun_noun_	Αἰνόπαρις_αἰνόπαρις_
κρατήσεις	verb_noun_	κρατέω_κράτησις_
καιρῶ	noun_verb_	καιρός_καιρόω_
ζωῶ	verb_adjective_	ζωόω_ζωός_
τεχνῶν	verb_verb_noun_	τεχνόω_τεχνάζω_τέχνη_
παρειά	noun_noun_	παρειάς_παρειά_
ἠῶθεν	adverb_adverb_	ἠῶθεν_ἕωθεν_
πόσις	noun_noun_	πόσις1_πόσις2_
πολεμουμένῃ	verb_verb_	πολεμόω_πολεμέω_
μαχησόμενος	verb_verb_	συμμαχέω_μάχομαι_
ἔρεξεν	verb_verb_	ῥέζω_ἐρέσσω_
σοί	pronoun_adjective_	σύ_σός_
Ἀσίην	adjective_adjective_noun_noun_	Ἄσιος_ἄσιος_Ἀσίας_Ἀσία_
φυλάσσεται	verb_verb_	φυλάσσω_φυλάζω_
διεξοῦσα	verb_verb_	διεξέω_διέχω_
κεράτων	verb_noun_	κερατόω_κέρας_
ὁρμήσειεν	verb_verb_	ὁρμέω_ὁρμάω_
Θύμβρης	noun_noun_noun_	Θύμβρις_θύμβρα_Θύμβρης_
ναίονται	verb_verb_	ναίω2_ναίω1_
θερμῇ	adjective_verb_	θερμός_θερμάζω_
κοῖλον	adjective_adjective_	κόιλος_κοῖλος_
ἔνθ᾽	verb_verb_adverb_	εἰμί_ἔρχομαι_ἔνθα_
Ἰσθμοῦ	noun_noun_	ἰσθμός_Ἰσθμός_
πάσαι	adjective_verb_verb_	πᾶς_πάσσω_πατέομαι_
ἡδέως	adverb_adjective_	ἡδέως_ἡδύς_
ἑξῆς	adverb_verb_	ἑξῆς_ἔχω_
Tυραννίων	verb_verb_	τυραννιάω_τυραννεύω_
χρόνω	noun_verb_	χρόνος_χρονόω_
πρώτας	adjective_adjective_	πρότερος_πρῶτος_
δαιμονίη	verb_adjective_	δαιμονιάω_δαιμόνιος_
ἐφύλαξε	verb_verb_	φυλάσσω_φυλάζω_
πρώταις	adjective_adjective_	πρῶτος_πρότερος_
ἐτράπησαν	verb_verb_verb_	τρέπω_τραπέω_τέρπω_
ἔχω	verb_verb_	ἔχω_χόω_
Ἐπίστροφος	noun_adjective_	Ἐπίστροφος_ἐπίστροφος_
οὐτάμενοι	verb_verb_	οὐτάω_οὐτάζω_
παραθῆται	verb_verb_	παρατίθημι_παραθέω_
γῆν	noun_noun_	Γαῖα_γῆ_
φθορᾶς	noun_noun_	φθορεύς_φθορά_
χερμάδιον	adjective_noun_	χερμάδιος_χερμάδιον_
κυμάτων	verb_noun_	κυματόω_κῦμα_
ἐπορεύοντο	verb_verb_	πορεύω_ἐφορεύω_
φυσίζοος	adjective_adjective_	φυσίζους_φυσίζοος_
Ἴλου	noun_noun_	Ἴλος_Ἶλος_
φυλάσσοντος	verb_verb_	φυλάζω_φυλάσσω_
πέφυκεν	verb_verb_	φύζω_φύω_
φυγὰς	noun_noun_	φυγή_φυγάς_
αὖε	verb_adjective_verb_	αὔω2_αὖος_αὔω1_
ἰδέειν	verb_verb_	εἶδον_ἰδέω_
ποιούμενοι	verb_verb_	ποιόω_ποιέω_
ἀναγκαῖαι	adjective_noun_	ἀναγκαῖος_ἀνάγκη_
ί̈δε	noun_noun_	ίδος_ιδος_
συντόνως	verb_adjective_	συντονόω_σύντονος_
πυρκαϊῇ	adjective_noun_	πυρκαιός_πυρκαιά_
ὦσιν	verb_noun_	εἰμί_ὦσις_
ἐρῶν	noun_verb_verb_noun_verb_	ἔρος2_ἐρῶ_ἐρέω_ἔρα_ἐράω1_
Πύρραν	noun_noun_	Πύρρα_πύρρα_
κάτα	preposition_adjective_	κατά_κάτος_
χέει	verb_verb_	χέω_χάω_
ὕψους	noun_verb_	ὕψος_ὑψόω_
τίς	pronoun_irregular_	τις_τίς_
μαχησόμενοι	verb_verb_	συμμαχέω_μάχομαι_
παριέναι	verb_verb_	παρίημι_πάρειμι2_
τίμου	noun_verb_	τῖμος_τιμόω_
φθάσῃ	verb_verb_	φθάνω_φθάζω_
κωλυτὴν	noun_adjective_	κωλυτής_κωλυτός_
ἐπαίρει	verb_verb_	ἐπαίρω_ἐφαιρέομαι_
χειρόνων	adjective_adjective_	χείρωνχείρων_χείρων_
ναίουσ'	verb_verb_	ναίω2_ναίω1_
θαρρῶν	verb_noun_	θαρσέω_θάρσος_
πράξει	noun_verb_	πρᾶξις_πράσσω_
εἴσομ'	verb_verb_	οἶδα_εἶμι_
πεισόμενος	verb_verb_	πείθω_πάσχω_
διαυγεῖς	adjective_verb_verb_	διαυγής_διαυγάζω_διαυγέω_
λέγουσαν	verb_verb_verb_	λέγω3_λέγω2_λέγω1_
εὐθέες	adjective_adjective_	εὐθύς1_εὐθής_
θυομένου	verb_verb_	θύω2_θύω1_
θαυμαστὰ	adjective_noun_	θαυμαστός_θαυμαστής_
τύπον	noun_noun_	τύπος_τύπον_
ἁλῴην	adjective_verb_	ἁλώιος_ἁλίσκομαι_
αἴσῃ	noun_noun_	Αἶσα_αἶσις_
ὤφειλεν	verb_verb_	ὀφείλω_ὀφέλλω_
ὑπομνήσει	verb_verb_noun_	ὑπομνάομαι_ὑπομιμνήσκω_ὑπόμνησις_
Δῆλον	noun_adjective_	Δῆλος_δῆλος_
φιλοῦσιν	verb_verb_	φιλέω_φιλόω_
ἐνστάσης	noun_verb_	ἔνστασις_ἐνίστημι_
θείους	verb_noun_adjective_	θειόω_θεῖος2_θεῖος1_
προτέρω	adverb_adjective_	προτέρω_πρότερος_
πολέων	verb_adjective_	πολέω_πολύς_
πρῶτος	adjective_adjective_	πρότερος_πρῶτος_
καταρράσσει	verb_verb_	καταρράσσω_καταρρήγνυμι_
δόξαν	noun_verb_	δόξα_δοκέω_
τάχιστον	adjective_adjective_	ταχύς_τάχιστος_
τἂν	preposition_conjunction_verb_preposition_preposition_conjunction_particle_	ἐν_ἐάν_εἰμί_εἰς_ἀνά_ἄν2_ἄν1_
Ἴ̈δη	verb_noun_noun_noun_noun_	ἰδέω_ἶδος_Ἴδης_ἴδη_Ἴδη_
χρυσοῦς	adjective_verb_	χρύσεος_χρυσόω_
Ἁλίη	adjective_noun_noun_adjective_noun_	ἅλιος2_ἁλίη_ἁλία_ἅλιος1_Ἁλίη_
νέομαί	verb_verb_verb_	νέω_νέομαι_νέω3_
οἴης	verb_adjective_noun_noun_	οἰάω_οἶος_οἴη_ὄις_
στάσαν	verb_verb_	στάζω_ἵστημι_
ξύλου	verb_noun_	ξυλόω_ξύλον_
πινούσαις	verb_verb_	πίνω_πινάω_
τιμωμένῳ	verb_verb_	τιμάω_τιμόω_
Θόαν	noun_noun_	Θόας_Θόη_
εἰρῆσθαι	verb_verb_	ἐρῶ_εἰρέω_
αὐτῶ	adverb_pronoun_	αὐτοῦ_αὐτός_
ἐποίσειν	verb_verb_	ἐποίζω_ἐπιφέρω_
μέλισσαι	verb_noun_	μελίζω_μέλισσα_
οὔλη	verb_adjective_adjective_adjective_	οὐλέω_ὅλοξ_οὖλος2_οὖλος3_
Ἐπειῶν	adjective_adjective_	Ἐπειοί_Ἐπειός_
νευράν	noun_noun_	νευρά_νευρή_
δεκαπλασίων	adjective_adjective_	δεκαπλασίων_δεκαπλάσιος_
μόρου	noun_noun_	μόρος_μόρον_
ἔταξεν	verb_verb_	τάσσω_ἐτάζω_
λιταῖς	adjective_noun_	λιτός_λιτή_
κραταιοὶ	adjective_verb_verb_	κραταιός_κραταιόω_κραταιόομαι_
Θανάτου	verb_noun_noun_	θανατόω_θάνατος_Θάνατος_
ἤχθετο	verb_verb_	ἔχθω_ἄχθομαι_
φρούριον	noun_verb_	φρούριον_φρουρέω_
λίσσεσθαι	verb_verb_	λίσσομαι_λίζω_
νεώτερον	adjective_adjective_	νέος_νεώτερος_
Ἀπίων	noun_noun_noun_noun_adjective_adjective_noun_	ἄπιος1_ἄπιον_Ἆπις_Ἀπ́ίων_ἀπίων_ἄπιος2_Ἀπίων_
ἀπολλυμένων	verb_verb_	ἀπολύω_ἀπόλλυμι_
ἀρθέντες	verb_verb_	ἀραρίσκω_αἴρω_
ἐγκεκλιμένως	verb_adverb_	ἐγκλίνω_ἐγκεκλιμένως_
ἱερὰ	adjective_noun_noun_	ἱερός_ἱερή_ἱερά_
στάσεις	verb_verb_noun_	στάζω_ἵστημι_στάσις_
ἀναφορέων	verb_noun_	ἀναφορέω_ἀναφορά_
ἐσθιόμενος	verb_verb_	εἰσθέω_ἐσθίω_
γνῶσι	verb_noun_	γιγνώσκω_γνῶσις_
ὕπνου	noun_noun_verb_	ὕπνος_ὕπνον_ὑπνόω_
Ἴδης	noun_verb_noun_noun_	Ἴδη_ἰδέω_ἴδη_Ἴδης_
ἀσεβεῖ	verb_adjective_	ἀσεβέω_ἀσεβής_
ἐπαύσατο	verb_verb_	παύω_ἐπαύω_
κέκτηται	verb_verb_	κτέομαι_κτάομαι_
μίξεως	noun_noun_	μῖξις_μίξις_
Αἴθραν	noun_noun_	Αἴθρη_αἴθρη_
καρπῷ	noun_noun_	καρπός2_καρπός1_
δένδρων	noun_verb_	δένδρον_δενδρόω_
μεταλλάξει	noun_verb_verb_	μετάλλαξις_μεταλήγω_μεταλλάσσω_
ἀλύξας	verb_verb_verb_	ἀλύζω_ἀλύσκω_ἀλύσσω_
Ἄρει	noun_noun_noun_noun_verb_noun_	Ἄρευς_Ἄρις_ἄρος_ἀρέμ_αἴρω_Ἄρης_
αἵ	article_pronoun_	ὁ_ὅς_
κνίσω	verb_verb_	κνίζω_κνισόω_
μισθοῦ	noun_verb_	μισθός_μισθόω_
ὅλην	adjective_adjective_	ὅλος_ὅλοξ_
δεξιὰ	noun_adjective_	δεξιά_δεξιός_
σκληροῦ	verb_adjective_	σκληρόω_σκληρός_
ὑπηκόων	noun_adjective_adjective_	ὑπήκοον_ὑπήκοος_ὑπήκους_
ἐπανηρημένος	ἀνά-ἐρέ_ἀνά-ἐρέομα_ἀνά-ἀράω_ἀνά-ἐράομα_ἀνά-ἀρέομα_	ἐπί_ἐπί_ἐπί_ἐπί_ἐπί_
κατεσμίκρυνε	verb_εἰσ-μικρύν_	κατά-σμικρύνω_κατά_
Αἰολὶς	noun_noun_	Αἰολεύς_Αἰολίς_
Ἶ̈ρις	noun_noun_	Ἶρις_ἶρις_
ἀνήρτηντο	verb_verb_	ἀναρτάω_ἀναρτέομαι_
ἐπικλᾶν	verb_verb_	ἐπικλάω_ἐπικλάζω_
ἄρχοντας	verb_noun_	ἄρχω_ἄρχων_
Κύπριος	adjective_adjective_	κύπριος_Κύπριος_
ὅτὶ	conjunction_adverb_pronoun_	ὅτι2_ὅτι1_ὅστις_
ὅλη	adjective_verb_adjective_	ὅλοξ_ὁλάω_ὅλος_
ἄρσαντες	verb_verb_	ἀραρίσκω_ἄρδω_
χαριζόμενα	verb_verb_	χαρίζομαι_χαρίζω_
μαντευσόμενος	verb_verb_	μαντεύω_μαντεύομαι_
κακῶν	verb_noun_verb_adjective_	κακάζω_κάκη_κακόω_κακός_
Νότος	noun_noun_	Νότος_νότος_
ἠβουλήθη	verb_verb_	ἀβουλέω_βούλομαι_
ᾠήθης	verb_verb_	οἰάω_οἴομαι_
παρίστησιν	verb_verb_	παρίστημι_παριστάω_
ναίω	verb_verb_adjective_	ναίω2_ναίω1_νήιος_
φέρτρον	noun_noun_	φέρτρον_φέρετρον_
βουλευτῇσι	noun_adjective_	βουλευτής_βουλευτός_
ἅ	pronoun_article_	ὅς_ὁ_
δίη	adjective_verb_	δῖος_δίεμαι_
ἀνήρτηνται	verb_verb_	ἀναρτέομαι_ἀναρτάω_
παρθενίαν	noun_noun_adjective_	παρθενία_παρθενίης_παρθένιος_
ἄκρω	adjective_noun_	ἄκρος_ἄκρον_
ξένω	verb_adjective_noun_	ξενόω_ξένος2_ξένος1_
ἐπίθετον	adjective_verb_verb_noun_	ἐπίθετος_πείθω_ἐπιτίθημι_ἐπίθετον_
Ἀγκαῖον	verb_noun_	ἀνακαίω_Ἀγκαῖος_
ἐφυλάχθη	verb_verb_	φυλάζω_φυλάσσω_
ἐπιτίμια	adjective_noun_	ἐπιτίμιος_ἐπιτίμιον_
πρῶτον	adjective_adjective_	πρῶτος_πρότερος_
βόας	noun_noun_verb_	βοῦς_βόα_βοάω_
ἤ	conjunction_exclamation_	ἤ1_ἤ2_
νικᾶν	verb_noun_	νικάω_νίκη_
προσεῖναι	verb_verb_	προσίημι_πρόσειμι1_
κασσιτέρου	noun_verb_	κασσίτερος_κασσιτερόω_
προνοῆσαι	verb_verb_	προνοοῦμαι_προνοέω_
κήδεα	noun_adjective_	κῆδος_κήδεος_
Κυθήροις	noun_noun_	Κύθηρα_Κύθηρος_
φρονίων	noun_verb_	φρόνις_φρονέω_
κείνων	pronoun_verb_adjective_	ἐκεῖνος_κενόω_κεῖνος_
ἀστρολόγον	adjective_noun_	ἀστρονόμος_ἀστρολόγος_
ξένης	noun_adjective_	ξένη_ξένος2_
Ἰφιγενείας	noun_noun_noun_	Ἰφιγενεία_Ἰφιγένεια_Ἰφίγενεια_
νίκη	noun_noun_verb_	νῖκος_νίκη_νικάω_
ἐχρῆτο	verb_verb_verb_verb_	χραύω_χράω1_χράω2_χράομαι_
ἰ̈ᾶτ'	verb_noun_	ἰάομαι_ἰᾶτον_
οἴ	exclamation_noun_	οἰ_ὄις_
τρόπου	verb_noun_	τροπόω_τρόπος_
γῆ	noun_noun_	γῆ_Γαῖα_
Χρυσίππου	noun_noun_	Χρυσίππος_Χρύσιππος_
πάθη	noun_noun_	πάθη_πάθος_
λεγομένων	verb_verb_verb_	λέγω1_λέγω3_λέγω2_
προσυνήχθη	verb_σύν-ἔσσομα_σύν-ἀχθέ_σύν-ἐχθέ_	πρό-συνάγω_πρό_πρό_πρό_
οὐρήων	noun_noun_	ὀρεύς_οὐρεύς_
πύθοιτο	verb_verb_	πύθω_πυνθάνομαι_
σταθμοῦ	noun_verb_verb_noun_verb_	σταθμόν_σταθμόω_σταθμόομαι_σταθμός_σταθμάομαι_
Γαῖα	noun_noun_	Γαῖα_γαῖα_
ἄνθη	noun_noun_verb_	ἄνθη_ἄνθος_ἀνθέω_
συμφραζομένων	verb_verb_	συμφράζομαι_συμφράζω_
τίνα	pronoun_irregular_	τις_τίς_
ἀντίθεόν	verb_adjective_verb_	ἀντιθέω_ἀντίθεος_ἀνατίθημι_
Πολίτου	noun_noun_	πολίτης_Πολίτης_
ἄνασσε	verb_verb_	ἀνάζω_ἀνάσσω_
ἐλεοῖσιν	verb_noun_verb_	ἐλεέω_ἐλεός_ἐλεάω_
τύψαι	verb_verb_	τύπτω_τύφω_
λύσσα	verb_noun_	λυσσάω_λύσσα_
ποίμνιον	adjective_noun_	ποίμνιος_ποίμνιον_
θηρίων	verb_noun_verb_	θηριόω_θηρίον_θηράω_
ἐμπλήσειν	verb_verb_	ἐμπίπλημι_ἐμπλέω_
λευκοῖο	noun_adjective_verb_	λευκόν_λευκός_λευκόω_
ἀφίστησι	verb_verb_	ἀφεστήξω_ἀφιστάω_
ἀμέλει	adverb_verb_	ἀμέλει_ἀμελέω_
ἐλαίου	noun_noun_verb_	ἔλαιον_ἔλαιος_ἐλαιόω_
ἥβης	verb_noun_verb_	ἅπτω_ἥβη_ἡβάω_
ἀγώνων	adjective_noun_	ἄγωνος_ἀγών_
κινητὰ	adjective_noun_	κινητός_κινητής_
ἐμπέδω	adjective_verb_	ἔμπεδος_ἐμπεδόω_
ὀΐεαι	verb_verb_	ὀίζω_οἴομαι_
ἐπιθήσω	verb_verb_verb_verb_	πιθέω_ἐπιτίθημι_ἐπιθέω_πείθω_
παρῶν	noun_adjective_verb_	πῆρος_πηρός_παρόω_
ἔασ'	verb_verb_	ἐάω_εἰμί_
ἀναΐξας	verb_verb_	ἀναίσσω_ἀνᾴσσω_
χείμαρρος	adjective_adjective_	χειμάρρους_χείμαρρος_
συνεσταλμένως	verb_adverb_	συστέλλω_συνεσταλμένως_
δύνω	verb_verb_	δύω2_δύναμαι_
ἀναπληρώσῃ	verb_noun_	ἀναπληρόω_ἀναπλήρωσις_
Ἴδα	noun_noun_noun_noun_	ἶδος_Ἴδης_ἴδη_Ἴδη_
κόπανον	noun_noun_	κόπανος_κόπανον_
λαγωὸν	noun_noun_	λαγῶς_λαγωός_
ἄλυπον	adjective_noun_	ἄλυπος_ἄλυπον_
Λιταῖς	noun_adjective_	λιτή_λιτός_
Φρυγίας	noun_noun_adjective_adjective_	Φρυγία_φρυγία_φρύγιος_Φρύγιος_
φυλάσσοντα	verb_verb_	φυλάσσω_φυλάζω_
σχέο	verb_verb_	ἔχω_σχάω_
κλαιούσας	verb_verb_	κλείω1_κλαίω_
ἁναπνεύσωσιν	verb_verb_	ἀναπνεύω_ἀναπνέω_
κυνώπιδος	noun_noun_	κυνώπης_κυνῶπις_
χρυσοῦ	noun_verb_adjective_	χρυσός_χρυσόω_χρύσεος_
πόσιν	noun_noun_	πόσις1_πόσις2_
κεκόρησθον	verb_verb_	κορέννυμι_κορέω_
μονονουχὶ	adverb_adverb_	μονονυχί_μονονού_
οὐδαμοῦ	adverb_adjective_	οὐδαμοῦ_οὐδαμός_
xρόα	noun_noun_	χρώς_χροιά_
καθεζόμενον	verb_verb_	κατά-καθέζομαι_κατά-ἕζομαι_
Ῥόδον	noun_noun_	ῥόδον_Ῥόδος_
ὑπαλύξει	verb_noun_	ὑπαλύσκω_ὑπάλυξις_
σῆ	verb_noun_	σέω_σής_
ἐπόπτης	verb_noun_	ἐποπτάω_ἐπόπτης_
μητρὶ	noun_noun_	μητρίς_μήτηρ_
Ἄκτορος	noun_noun_	ἄκτωρ_Ἄκτωρ_
ἱστῷ	verb_noun_	ἱστάω_ἱστός_
ἀσθενούσης	verb_verb_	ἀσθενέω_ἀσθενόω_
παρῴδηνται	verb_verb_	παρά-οἰδέω_παρά-οἰδάω_
ἀγοράασθε	verb_verb_	ἀγοράομαι_ἀγοράζω_
νηὸς	noun_noun_	ναός_ναῦς_
Ἰ¨ξίων	noun_noun_noun_	ἰξίον_Ἴξιος_Ἰξίων_
χαλάζης	verb_noun_	χαλαζάω_χάλαζα_
πρόεϊκε	verb_verb_	πρό-ἔοικα_πρό-εἴκω_
Πέρσαις	noun_verb_	Πέρσης_πέρθω_
Πολυείδῳ	noun_noun_	Πολύειδος_Πολύειδον_
ἀποφάσεως	noun_noun_	ἀπόφασις2_ἀπόφασις1_
μάχης	noun_verb_	μάχη_μαχάω_
πυθόμενος	verb_verb_	πύθω_πυνθάνομαι_
ἀμφιβόων	verb_verb_	ἀμφί-βάζω_ἀμφί-βοάω_
καθέζεται	verb_verb_	κατά-καθέζομαι_κατά-ἕζομαι_
ἐπιφάνειαν	noun_verb_	ἐπιφάνεια_ἐπιφαίνω_
οἰκεῖον	adjective_verb_verb_	οἰκεῖος_οἰκέω_οἰκείω_
φάρμακον	noun_noun_	φάρμακος_φάρμακον_
καρηκομόωντες	verb_verb_	καρηκομόω_καρηκομόωντες_
οἴκοι	verb_adverb_	ἔοικα_οἴκοι_
ἄρης	noun_verb_noun_noun_	ἀρή_ἀράω2_Ἄρης_ἀρά_
Αἴθρα	noun_noun_	Αἴθρη_αἴθρη_
φυλάσσει	verb_verb_	φυλάσσω_φυλάζω_
Ἶρις	noun_noun_	Ἶρις_ἶρις_
Σπάρτῃ	noun_noun_	σπάρτη_Σπάρτη_
τά	irregular_article_	τίς_ὁ_
φύσας	verb_verb_noun_verb_verb_	φυσάω_φύω_φῦσα_φύσας_φύζω_
πρόθεις	verb_verb_	προθέω1_προθέω_
ἀδολέσχης	noun_verb_	ἀδολέσχης_ἀδολεσχέω_
ψεύδεα	noun_noun_	ψεῦδος_ψεῦδις_
χέοντες	verb_verb_	χάω_χέω_
ἀναιροῦνται	verb_verb_	ἀνιερόω_ἀναιρέω_
ἀναπτόμενον	verb_verb_	ἀναπέτομαι_ἀνάπτω_
πολιχνίου	noun_noun_	πολίχνη_πολίχνιον_
νοῶν	verb_verb_	νοόω_νοέω_
ἐπιπλώσας	verb_verb_	ἐπιπλέω_ἐπιπλάζω_
ἤρυγεν	verb_verb_	ἀρύσσομαι_ἐρεύγομαι_
ἀρῶ	verb_verb_verb_verb_verb_	αἴρω_ἀρόω_ἀράζω_ἀείρω_ἀράομαι_
ᾠδὴν	noun_noun_	ᾠδή_ἀοιδή_
πάσαν	verb_adjective_	πάσσω_πᾶς_
κέλεαι	verb_verb_	κέλομαι_κέλλω_
Κύπρος	noun_noun_	Κύπρος_κύπρος_
διαστολῆς	noun_noun_	διαστολή_διαστολεύς_
Πατρόκλω	noun_noun_	Πατρόκλον_Πάτροκλος_
πόρους	verb_noun_	πορόω_πόρος_
πάλη	noun_noun_verb_	πάλα_πάλη_παλέω_
λευκὸν	adjective_noun_	λευκός_λευκόν_
χειμάρροος	adjective_adjective_	χειμάρρους_χειμάρροος_
βλέπει	verb_noun_	βλέπω_βλέπος_
ἀθανάτω	verb_adjective_	ἀθανατόω_ἀθάνατος_
πολεμίω	verb_adjective_	πολεμέω_πολέμιος_
ἓν	noun_verb_	εἷς_ἵημι_
ἑτέρη	adjective_verb_	ἕτερος_ἑτερέω_
μηνίσαντα	verb_verb_	μηνίζω_μηνίω_
Θήβας	noun_noun_	Θῆβαι_Θήβη_
Ἴ¨ριδι	noun_noun_	Ἴρις_Ἶρις_
χασσάμενος	verb_verb_	χάζομαι_χάζω_
ἠχῇ	verb_noun_	ἠχέω_ἠχή_
κοίλην	adjective_adjective_	κοῖλος_κόιλος_
λέγω	verb_adjective_verb_verb_	λέγω1_λέγος_λέγω3_λέγω2_
ἔσχαται	adjective_verb_	ἔσχατος_σχάω_
οἰηθέντες	verb_verb_	οἰάω_οἴομαι_
φθάσαντος	verb_verb_	φθάζω_φθάνω_
Σκύρου	noun_noun_noun_noun_	Σκύρας_Σκῦρος_σκῦρος_σκύρον_
ἀρσενικὸν	adjective_noun_	ἀρσενικός_ἀρσενικόν_
ἔναιεν	verb_verb_	ναίω2_ναίω1_
πλέω	adjective_adjective_verb_	πλείων_πλέος_πλέω_
ἔλεγες	verb_verb_verb_	λέγω1_λέγω3_λέγω2_
θήρης	verb_noun_	θηράω_θήρα_
ἔστω	verb_verb_	ἵστημι_εἰμί_
ἔλιπεν	verb_verb_	λίπτομαι_λείπω_
ῥόον	noun_noun_	ῥόον_ῥόος_
νυμφίον	adjective_noun_	νυμφίος2_νυμφίος1_
ἔλεγχον	noun_verb_	ἔλεγχος2_ἐλέγχω_
Πυθίας	noun_adjective_	Πυθία_Πύθιος_
πλήθη	noun_verb_	πλῆθος_πίμπλημι_
Ἐλεῶν	noun_verb_noun_noun_verb_	ἐλέα_ἐλεέω_ἔλεος_Ἐλεοῦς_ἐλεάω_
πυρὴν	noun_noun_	πυρή_πυρήν_
ἔπεισεν	verb_verb_	πείθω_ἐφίζω_
λέγηται	verb_verb_verb_	λέγω1_λέγω2_λέγω3_
δεκάτη	noun_adjective_	δεκάτη_δέκατος_
ἀντιθῇ	verb_verb_verb_	ἀντιτίθημι_ἀντιθέω_ἀνατίθημι_
κύκλω	verb_noun_	κυκλόω_κύκλος_
ἐπέταξε	verb_verb_	ἐπιτάσσω_πετάζω_
ὅλαι	adjective_adjective_	ὅλοξ_ὅλος_
ἅδην	adverb_noun_	ἅδην_ἅδος_
καταρχάς	noun_adverb_	καταρχή_καταρχάς_
ἠέλιος	noun_noun_	ἠέλιος_ἥλιος_
Δίας	noun_adjective_	Δίη_δῖος_
Ἕκτορας	noun_noun_	Ἕκτωρ_ἕκτωρ_
γήρας	noun_verb_verb_	γῆρας_γηράω_γηράσκω_
ἀπεδέξατο	verb_verb_	ἀποδείκνυμι_ἀποδέχομαι_
δόξω	verb_verb_	δοκέω_δοξόω_
ἀποδοκιμάσῃς	verb_verb_	ἀποδοκιμάω_ἀποδοκιμάζω_
κολεὸν	noun_noun_	κολεός_κολεόν_
ῥίψεις	noun_verb_	ῥῖψις_ῥίπτω_
κόμας	verb_noun_	κομάω_κόμη_
ὑμᾶς	adjective_pronoun_	ὑμός_σύ_
ἀρίστου	adjective_noun_	ἄριστος_ἄριστον_
ἀπόπλουν	adjective_verb_	ἀπόπλοος_ἀποπλέω_
σόος	adjective_adjective_	σῶς_σόος_
ξένας	adjective_noun_	ξένος2_ξένη_
καθεστῶτα	verb_noun_	καθίστημι_καθεστῶτα_
συμμαχήσῃ	verb_verb_	συμμάχομαι_συμμαχέω_
κορυφῆισι	verb_noun_	κορύπτω_κορυφή_
δεξιᾷ	verb_noun_adjective_verb_	δεξιόομαι_δεξιά_δεξιός_δεξιάζω_
ποιοῦντες	verb_verb_	ποιόω_ποιέω_
παρά	adjective_preposition_	πηρός_παρά_
Φρυγία	adjective_adjective_noun_noun_	Φρύγιος_φρύγιος_φρυγία_Φρυγία_
πρῆσαι	verb_verb_	πίμπρημι_πρήθω_
θοοὶ	verb_adjective_	θοόω_θοός_
δαίδαλα	adjective_verb_	δαίδαλος_δαιδάλλω_
ὀχέων	noun_noun_noun_	ὀχή_ὄχος_ὀχεύς_
κτῆσιν	noun_verb_verb_verb_	κτῆσις_κτάομαι_κτείνω_κτέομαι_
Ὀλυμπιακὸν	adjective_adjective_	Ὀλυμπιακός_Ὀλυμπιακός_
ἴ̈̈ρισσιν	noun_noun_	ἶρις_Ἶρις_
ὀρχούμενοι	verb_verb_	ὀρχέομαι_ὀρχέω_
εἰδώς	noun_verb_	εἰδοί_οἶδα_
ἀποχρῆται	verb_verb_	ἀποχράομαι_ἀποχράω_
φρῶ	verb_verb_	φράζω_φρέω_
ἕκταν	adjective_noun_	ἕκτος_ἕκτη_
Ἀγχίσαο	noun_verb_	Ἀγχίσης_ἀγχίζω_
παραδεκτέα	adjective_adjective_	παραδεκτέος1_παραδεκτέος2_
ἂρ'	verb_verb_noun_particle_	αἴρω_ἀρόω_ἄρον_ἄρα_
φλογὶ	noun_noun_	φλογίς_φλόξ_
ἀλείτην	verb_verb_noun_	ἀλέω_εἴλω_ἀλείτης_
τέκνων	verb_noun_	τεκνόω_τέκνον_
διαβάσεις	verb_noun_	διαβαίνω_διάβασις_
ἀορίστου	adjective_verb_	ἀόριστος_ἀοριστόω_
Ἐρινύες	verb_noun_	ἐρινύω_Ἐρινύς_
φλεβῶν	verb_noun_	φλεβάζω_φλέψ_
εὐθὺ	adjective_adverb_	εὐθύς1_εὐθύς2_
κέληθ'	noun_verb_	κέλης_κέλομαι_
Χείρων	adjective_noun_noun_verb_	χείρων_Χείρωνες_Χείρων_χειρόω_
βίον	verb_noun_	βιόω_βίος_
κείων	verb_verb_verb_verb_	κείω1_κεῖμαι_κείω_κείω2_
χαριζόμενος	verb_verb_	χαρίζομαι_χαρίζω_
τοῖσιν	irregular_article_	τίς_ὁ_
μέθης	verb_noun_	μέθημαι_μέθη_
Λεκτὸν	noun_adjective_	Λεκτός_λεκτός_
χηλοῦ	noun_verb_	χηλός_χηλόω_
Ἔρυσον	noun_verb_	ἔρυσος_ἐρύω_
νέους	adjective_verb_	νέος_νεόω_
συντάξει	verb_noun_verb_	συντήκω_σύνταξις_συντάσσω_
ἄγετ'	adverb_verb_	ἄγε_ἄγω_
ὑποτιμώμενος	verb_verb_	ὑποτιμάομαι_ὑποτιμάω_
ἐπειράσατο	verb_verb_	πειράζω_πειράω_
ἔθετο	verb_verb_	ἔθω_τίθημι_
αὐθεντῶν	noun_verb_	αὐθέντης_αὐθεντέω_
θηλῆς	verb_verb_noun_	θηλέω_θηλάζω_θηλή_
τοὐναντίον	adverb_adjective_	ἐναντίον_ἐναντίος_
ἥρωϊ	noun_noun_	ἥρως_ἥρως_
ἱεροῖσι	adjective_verb_	ἱερός_ἱερόω_
ὀλιγοδρανέων	verb_adjective_verb_	ὀλιγοδρανέω_ὀλιγοδρανής_ὀλιγοδρανέων_
παροῦσι	verb_verb_verb_	παρόω_πάρειμι1_πείρω_
ἀρᾶται	verb_verb_	ἀράζω_ἀράομαι_
ἠέλιός	noun_noun_	ἥλιος_ἠέλιος_
νέον	verb_verb_verb_verb_adjective_	νέω_νέω2_νέω1_νέω3_νέος_
Διά	preposition_noun_	διά_Ζεύς_
ἐπινεύσας	verb_verb_verb_verb_verb_	ἐπινάω_ἐπινέω3_ἐπινεύω_ἐπινέω2_ἐπινέω_
ἐσθίοντες	verb_verb_	ἐσθίω_εἰσθέω_
ἡδονήν	noun_noun_	ἡδονή_ἡδονά_
κεῖται	verb_verb_	κεῖμαι_κέω_
τιμῶνται	verb_verb_verb_	τμάω_τιμέω_τιμόω_
πόντου	verb_noun_verb_	ποντόω_πόντος_ποντίζω_
Λυκίᾳ	noun_adjective_	Λυκία_Λύκιος_
ἐνῆν	verb_verb_	ἐν-εἰμί_ἐν-ἠμί_
φρίκη	noun_noun_	φρίκη_φρῖκος_
ἐδωρήσατο	verb_verb_	δωρέω_δωρέομαι_
λεγόμενα	verb_verb_verb_	λέγω1_λέγω2_λέγω3_
μελαίνῃ	adjective_verb_noun_	μέλας_μελαίνω_μέλαινα_
περισπωμένως	verb_adverb_	περισπάω_περισπωμένως_
ἐφορμῆσαι	verb_verb_	ἐφορμέω_ἐφορμάω_
ὀρθῶν	verb_adjective_	ὀρθόω_ὀρθός_
ἔτ'	noun_adverb_noun_	ἔται_ἔτι_ἔτης_
κατεδεξάμην	verb_verb_	καταδείκνυμι_καταδέχομαι_
οἳ	pronoun_pronoun_article_	ἕ_ὅς_ὁ_
καιροῦ	verb_noun_	καιρόω_καιρός_
συνῆκεν	verb_verb_	συνήκω_συνίημι_
οὖρα	noun_noun_	οὖρον1_οὖρον2_
διορύξει	noun_verb_	διόρυξις_διορύσσω_
ἡττηθῇ	verb_verb_	ἡττάω_ἡσσάομαι_
λῆξιν	noun_noun_	λῆξις2_λῆξις1_
Ἄδραστος	adjective_noun_	ἄδραστος_Ἄδραστος_
Λάμπου	noun_verb_	Λάμπος_λάμπω_
ἔξω	adverb_verb_	ἔξω_ἔσσομαι_
ἀπονέοντο	verb_verb_	ἀπονέομαι_ἀπονέω_
περικεφαλαία	noun_adjective_	περικεφαλαία_περικεφάλαιος_
ἐκτησάμεθα	verb_verb_	κτάομαι_κτέομαι_
παντοπώλης	noun_verb_	παντοπώλης_παντοπωλέω_
πεδίου	noun_noun_	πέδιον_πεδίον_
Ξάνθης	noun_noun_verb_	Ξάνθης_ξάνθη_ξαίνω_
ἰαχῇ	noun_verb_	ἰαχή_ἰαχέω_
οἰκτίρμονες	adjective_noun_	οἰκτίρμων_οἰκτιρμων_
πόσεϊ	noun_noun_	πόσις1_πόσις2_
μαθῶν	noun_noun_	μάθος_μάθη_
συνήρχοντο	verb_verb_	συνάρχω_συνέρχομαι_
εἰσάγη	verb_verb_	εἰσ-ἀγάω_εἰσ-ἄγνυμι_
δεινῶν	verb_verb_adjective_	δεινάζω_δεινόω_δεινός_
λελασμένος	verb_verb_	λάζομαι_λάζω_
μορίῳ	adjective_noun_	μόριος_μόριον_
ἄμ'	noun_noun_	ἄμπ_ἄμη_
ῥηγέντα	verb_verb_	ῥήγνυμι_ῥήσσω_
τειχῶν	noun_verb_	τεῖχος_τειχέω_
οὕν	noun_verb_verb_preposition_preposition_	εἷς_ἵημι_εἰμί_ἐν_εἰς_
κοίλης	adjective_adjective_	κόιλος_κοῖλος_
Αἰγυπτίων	verb_adjective_	Αἰγυπτιόω_Αἰγύπτιος_
Τρῳὰς	noun_adjective_	Τρῳάς_Τρωιός_
ἀνήσομεν	verb_verb_	ἀνέω_ἀνίημι_
Ἀθηναίων	adjective_noun_noun_noun_	Ἀθηναῖος_Ἀθήναιος_Ἀθήναιον_Ἀθήναια_
νευρᾶς	noun_noun_	νευρή_νευρά_
θείω	noun_adjective_verb_verb_verb_verb_	θεῖος2_θεῖος1_θειόω_θεάω_θέω_τίθημι_
ὑδάτων	verb_noun_	ὑδατόω_ὕδωρ_
ἔδει	verb_verb_verb_verb_	δέω2_δέω1_ἔδω_ἐσθίω_
ἐμὲ	adjective_pronoun_	ἐμός_ἐγώ_
κορυφὰς	noun_noun_	κορυφάς_κορυφή_
τυπῇσιν	verb_noun_	τύπτω_τυπή_
νέαις	noun_adjective_	νέα_νέος_
ἐρείομεν	verb_verb_	ἐρέω_ῥέω_
ἐξίστησι	verb_verb_	ἐξιστάω_ἐξίστημι_
ξυνὸν	adjective_verb_	ξυνός_σύνειμι1_
παραγωγῆς	noun_noun_	παραγωγή_παραγωγεύς_
δοκοῦντα	verb_verb_	δοκόω_δοκέω_
Παιήον'	noun_noun_	Παιάν_Παιήων_
ἀρχὴν	adverb_noun_	ἀρχήν_ἀρχή_
εἶπον	noun_verb_	εἶπος_εἶπον_
ἐπάλλου	verb_verb_	πάλλω_ἐφάλλομαι_
φανερῶς	adjective_verb_	φανερός_φανερόω_
ἤϊσαν	verb_verb_	εἶμι_ἀείδω_
φανῆναι	verb_verb_	φανάω_φαίνω_
χαλκῆν	adjective_adjective_	χάλκεος_χαλκοῦς_
Δαναοί	noun_noun_	Δαναοί_Δαναός_
ὤφειλε	verb_verb_	ὀφέλλω_ὀφείλω_
Στωϊκὸς	adjective_adjective_	Στωικός_στωικός_
δεξώμεθα	verb_verb_	δείκνυμι_δέχομαι_
ἄθλοις	noun_noun_	ἆθλον_ἆθλος_
μέρή	noun_noun_	μέρος_μέρα_
μυεῖσθαι	verb_verb_	μυέω_μυάω_
λέγοι	verb_adjective_verb_verb_	λέγω1_λέγος_λέγω3_λέγω2_
σιγῇ	verb_noun_verb_	σιγάω_σιγή_σιγάζω_
κρεμάσαντες	verb_verb_	κρεμάζω_κρεμάννυμι_
ἀλῶ	verb_verb_verb_	ἀλέω_ἀλάομαι_ἀλόω_
ἀνέμω	noun_verb_	ἄνεμος_ἀνεμόω_
σόῃ	adjective_verb_adjective_	σῶς_σόω_σόος_
λεγόμενόν	verb_verb_verb_	λέγω1_λέγω3_λέγω2_
ἐγκύκλιον	verb_adjective_	ἐγκυκλέομαι_ἐγκύκλιος_
πῇ	noun_particle_	πῆ_πη_
μαχήσομαι	verb_verb_verb_verb_verb_	συμμαχέω_συμ́ω_μαχέω_μάχομαι_μαχάω_
ὀρέξῃ	noun_verb_	ὄρεξις_ὀρέγω_
νεῖκος	noun_noun_	νεῖκος_νει_
στένει	noun_verb_	στένος_στένω_
ἐλέησεν	verb_verb_	ἐλεέω_ἐλεάω_
χολωσάμεναι	verb_verb_	χολόω_χολόομαι_
ἔργων	verb_noun_	ἔργνυμι_ἔργον_
εἶσὶν	verb_verb_	εἴσειμι_εἶμι_
τάξεις	verb_noun_verb_	τάσσω_τάξις_τήκω_
σόῃς	adjective_adjective_verb_	σόος_σῶς_σόω_
βοῶν	verb_noun_adjective_noun_verb_noun_	βοόω_βοή_βόειος_βόα_βοάω_βοῦς_
λευκά	noun_adjective_noun_	λευκόν_λευκός_λευκάς_
βιβᾶς	verb_verb_	βιβάω_βιβάζω_
κέκληται	verb_verb_	καλέω_κέλομαι_
Σκαιάων	noun_noun_adjective_adjective_	Σκαίη_Σκαιαί_σκαιός_Σκαιός_
προστάξαντος	verb_verb_	προστάσσω_προσστάζω_
ἐμοὶ	adjective_pronoun_	ἐμός_ἐγώ_
αἰδῶ	noun_noun_	αἰδώς_αἰδώ_
τοί	article_pronoun_particle_	ὁ_σύ_τοι_
ἐπέεσσ'	verb_verb_noun_	ἐφίημι_ἐφέζομαι_ἔπος_
Ὀδυσσείας	adjective_noun_	Ὀδύσσειος_Ὀδύσσεια_
ἐπέχει	verb_verb_	ἐπώχατο_ἐπιχέω_
πείρην	verb_verb_	πειράω_πείρω_
ἀνατεταμένον	verb_noun_	ἀνατείνω_ἀνατεταμένον_
ἀντιφορτιζομένων	verb_verb_	ἀντιφορτίζομαι_ἀντιφορτίζω_
πρώτου	adjective_adjective_	πρῶτος_πρότερος_
δύω	numeral_verb_	δύο_δύω2_
ψαύσῃ	noun_verb_	ψαῦσις_ψαύω_
φορεῖ	verb_noun_	φορέω_φορεύς_
χηρῶν	noun_verb_	χήρα_χηρόω_
ἐντολῇ	noun_noun_	ἐντολή_ἐντολεύς_
Λυκίην	noun_adjective_	Λυκία_Λύκιος_
αἰτίας	noun_adjective_	αἰτία_αἴτιος_
κλείου	verb_verb_verb_	κλείω2_κλέω_κλείω1_
ποιητὰς	noun_adjective_	ποιητής_ποιητός_
ἅλως	verb_noun_noun_	ἁλίσκομαι_ἧλος_ἅλως_
ῥῆξαι	verb_verb_	ῥήσσω_ῥήγνυμι_
χεύομεν	verb_verb_	χεύω_χέω_
φυλάσσοντας	verb_verb_	φυλάσσω_φυλάζω_
ἄκουσαν	verb_adjective_	ἀκούω_ἀέκων_
σέ	adjective_pronoun_	σός_σύ_
τροπῆς	verb_noun_	τροπέω_τροπή_
μέλαιναι	adjective_noun_	μέλας_μέλαινα_
ἕσσατο	verb_verb_	ἵζω_ἕννυμι_
ἐπικλάσαι	verb_verb_	ἐπικλάζω_ἐπικλάω_
ἐμπεπλῆσθαι	verb_verb_	ἐμπίπλημι_ἐμπελάζω_
Μοῦσαι	noun_noun_	Μοῦσα_Μοῦσαι_
κεκοπῶσθαι	verb_verb_	κοπόω_κοπιάω_
πειράσαντας	verb_verb_	πειράζω_πειράω_
κυδοιμοῦ	noun_verb_	κυδοιμός_κυδοιμέω_
νέω	adjective_adverb_verb_verb_verb_verb_	νέος_νέω4_νεόω_νέω1_νέω3_νέω_
κλήρου	verb_noun_	κληρόω_κλῆρος_
φύζα	noun_noun_	φῦζα_φύζα_
μῶσα	verb_noun_	μῶμαι_Μοῦσαι_
κρεῖον	noun_noun_	κρεῖον_κρείων_
ἕρμα	noun_noun_	ἕρμα2_ἕρμα1_
θύειν	verb_verb_	θύω1_θύω2_
Εὐριπίδης	noun_noun_	Εὐριπίδης_εὐριπίδης_
πύργους	noun_verb_	πύργος_πυργόω_
οὐρανοῦ	noun_verb_	οὐρανός_οὐρανόω_
μέσων	verb_adjective_	μεσόω_μέσος_
πράξεισ	noun_verb_	πρᾶξις_πράσσω_
νοητέον	adjective_adjective_	νοητέον_νοητέος_
Πάριος	noun_adjective_adjective_	πῆρος_Πάρος_Πάριος_
μαθητῶν	adjective_noun_	μαθητός_μαθητής_
ἰών	verb_verb_	εἰμί_εἶμι_
ἔχει	verb_verb_verb_noun_	χέω_ἔχω_χάω_ἔχις_
αὐλητῆρος	noun_noun_	αὐλητής_αὐλητήρ_
ἐλισσόμενον	verb_verb_	ἐλίσσω_ἑλίσσω_
ἀνέμων	noun_verb_	ἄνεμος_ἀνεμόω_
ἀπήρχετο	verb_verb_	ἀπάρχομαι_ἀπέρχομαι_
ἔριον	verb_noun_	ἐρέω_ἔριον_
δωρουμένη	verb_verb_	δωρέομαι_δωρέω_
δέον	verb_verb_verb_noun_	δεῖ_δέω2_δέω1_δέον_
μήδεσι	noun_noun_	μῆδος2_μῆδος1_
Πλειάδων	noun_noun_	Πλειάδες_Πλειάς_
μήλοισιν	noun_noun_	μῆλον1_μῆλον2_
πολυκοιρανίῃ	noun_noun_	πολυκοιρανία_πολυκοιρανίη_
σοὶ	pronoun_adjective_	σύ_σός_
ἀπειθῶν	adjective_verb_	ἀπειθής_ἀπειθέω_
βοράν	noun_adjective_	βορά_βορός_
ἰ̈ῶ	noun_verb_verb_noun_verb_	ἰός1_ἰάζω_ἰόω_ἰός2_ἰάομαι_
θεῖόν	verb_noun_adjective_	θέω_θεῖος2_θεῖος1_
τιμήσωνται	verb_verb_	τιμέω_τιμάω_
δεῖνος	noun_noun_	δεῖνος_δεῖνα_
τίνες	verb_pronoun_irregular_	τίνω_τις_τίς_
οὐδὲ	noun_noun_particle_	οὐδός2_οὐδός1_οὐδέ_
εἰρόμεναι	verb_verb_verb_	ἔρομαι_εἴρω2_εἴρω_
παραγενήσῃ	noun_verb_	παραγένησις_παραγίγνομαι_
διῃρημένως	verb_adverb_	διαιρέω_διῃρημένως_
σόοι	adjective_adjective_	σόος_σῶς_
ὄντα	verb_noun_	εἰμί_ὄντα_
Ἅλιον	adjective_noun_noun_adjective_	ἅλιος2_Ἅλιος_ἥλιος_ἅλιος1_
Φοίβης	noun_adjective_verb_noun_	φοίβη_φοῖβος_φοιβάω_Φοίβη_
λατύπη	verb_noun_	λατυπέω_λατύπη_
ματαίως	verb_adjective_	ματαιόω_μάταιος_
κατώτατος	adjective_adjective_	κάτος_κατώτατος_
ἀγρία	verb_noun_adjective_	ἀγριάω_ἀγρία_ἄγριος_
πτολεμίζων	verb_verb_	πτολεμίζω_πολεμίζω_
ἤχθη	verb_verb_verb_verb_	ἀχθέω_ἐχθέω_ἄγω_ἔσσομαι_
ἀήτη	noun_noun_	ἀήτη_ἀήτης_
μαρτυρεῖ	verb_verb_	μαρτυρέω_μαρτύρομαι_
αἱρετὰ	noun_adjective_	αἱρετής_αἱρετός_
Μούσαι	noun_noun_	Μοῦσαι_Μοῦσα_
ὄχ'	noun_adverb_	ὄχος_ὄχα_
πρώται	adjective_adjective_	πρῶτος_πρότερος_
σιδηροῦ	adjective_verb_	σιδήρεος_σιδηρόω_
αὐτοχειρὶ	adverb_noun_	αὐτοχειρί_αὐτόχειρ_
λέγῃ	verb_verb_verb_adjective_	λέγω1_λέγω3_λέγω2_λέγος_
μόνου	adjective_verb_	μόνος_μονόω_
ἰχθύων	verb_noun_	ἰχθυάω_ἰχθύς_
ἐρέω	verb_verb_	ἐρῶ_ἐρέω_
ἀφόρητον	verb_adjective_	ἀφοράω_ἀφόρητος_
λευκοί	verb_adjective_	λευκόω_λευκός_
Ἀριστόνικον	adjective_noun_	ἀριστόνικος_Ἀριστόνικος_
Ἐνετῶν	noun_noun_adjective_	ἐνετή_Ἐνετοί_ἐνετός_
ἀπαλλάξαι	verb_verb_	ἀπαλλαξείω_ἀπαλλάσσω_
χείρονα	adjective_adjective_	χείρωνχείρων_χείρων_
ἄληκτον	adjective_adjective_	ἄληκτος_ἄλληκτος_
νῆσον	noun_verb_verb_verb_	νῆσος_νέω_νέω3_νέω2_
μῆλ᾽	noun_noun_noun_	μῆλον2_μήλη_μῆλον1_
ἰσχίων	noun_noun_	ἰσχίον_ἴσχιον_
Κρήτης	noun_noun_	Κρήτη_κρήτη_
εἶκε	verb_verb_	ἔοικα_εἴκω_
ἐμ'	adjective_pronoun_	ἐμός_ἐγώ_
νέοι	adjective_verb_verb_verb_verb_	νέος_νέω3_νέω1_νέω2_νέω_
ὀρνέων	noun_verb_	ὄρνεον_ὀρνεόω_
ἐπερρώσαντο	verb_verb_	ἐπιρρώννυμι_ἐπιρρώομαι_
νέμεϊ	verb_noun_	νέμω_νέμος_
ἱεράν	noun_adjective_	ἱερά_ἱερός_
κεχολώσεται	verb_verb_	χολόω_χολόομαι_
ἄνευ	verb_preposition_	ἄνω1_ἄνευ_
λόγω	verb_noun_	λογόω_λόγος_
ὀδόντων	noun_noun_	ὀδών_ὀδούς_
σάωσε	verb_verb_	σώζω_σαόω_
μήτ'	adverb_particle_	μήτις_μήτε_
ἐλάσσους	verb_adjective_	ἐλασσόω_ἐλάσσων_
λύκου	noun_verb_	λύκος_λυκόω_
ὁρμήσαντος	verb_verb_	ὁρμάω_ὁρμέω_
πάσας	verb_adjective_	πάσσω_πᾶς_
νηῒ	noun_noun_	Ναιάς_ναῦς_
Κρήτη	noun_noun_	κρήτη_Κρήτη_
δόξει	verb_noun_	δοκέω_δόξις_
δόρπος	noun_noun_	δόρπος_δόρπον_
Πίσης	noun_noun_	πίσα_Πῖσα_
ἐπῆρσεν	verb_verb_	ἐπαραρίσκω_ἐπάρδω_
Δαρδανίας	noun_adjective_	Δαρδανία_Δαρδάνιος_
Σκαιάς	noun_noun_adjective_adjective_	Σκαιαί_Σκαίη_σκαιός_Σκαιός_
ποιητῇ	noun_adjective_	ποιητής_ποιητός_
ὑπερίων	verb_verb_	ὑπό-ἐρέω_ὑπέρ-ἰόω_
ῥιγῶ	verb_verb_	ῥιγέω_ῥιγόω_
Νηλέως	adjective_noun_	νηλής_Νηλεύς_
ἔγρεο	verb_verb_	ἐγείρω_ἔγρω_
ἄπειμι	verb_verb_	ἄπειμι1_ἄπειμι2_
θυρῶν	verb_verb_noun_	θυράζω_θυρόω_θύρα_
πήξει	verb_noun_verb_	πήσσω_πῆξις_πήγνυμι_
κισσῷ	noun_verb_	κισσός_κισσάω_
χειρὶ	noun_noun_	χειρίς_χείρ_
πάσης	adjective_noun_	πᾶς_πᾶσις_
Σκαιοῦ	adjective_adjective_	Σκαιός_σκαιός_
ἔβρισαν	verb_verb_	βρίθω_βρίζω_
ἀριστέων	noun_adjective_verb_	ἀριστεύς_ἄριστος_ἀριστάω_
παρηρτημένος	verb_verb_	παραρτέομαι_παραρτάομαι_
ὀλεθρίαις	noun_adjective_	ὀλεθρία_ὀλέθριος_
Κλυταιμνήστρας	noun_noun_	Κλυταιμνήστρη_Κλυταιμνήστρα_
ὀφείλει	verb_verb_verb_	ὀφέλλω_ὀφειλέω_ὀφείλω_
Λίνος	noun_noun_	Λίνος_λίνος_
ἀνατολάς	adverb_noun_	ἀνατολάς_ἀνατολή_
ἀποδέξασθαι	verb_verb_	ἀποδείκνυμι_ἀποδέχομαι_
μαλακοῖσι	verb_adjective_	μαλακόω_μαλακός_
στίβη	verb_noun_	στιβέω_στίβη_
ἔρος	noun_noun_	ἔρος1_ἔρος2_
χάριτος	noun_adjective_	χάρις_χάριτος_
ἐεισάσθην	verb_verb_	εἴδομαι_εἶμι_
ὀρθοῖς	verb_adjective_	ὀρθόω_ὀρθός_
νεωτέρους	adjective_adjective_	νέος_νεώτερος_
εὐθεῖᾳ	adjective_noun_	εὐθύς1_εὐθεῖα_
παρεῖται	verb_verb_	παρέζομαι_παρίημι_
ἡμέρας	noun_adjective_	ἡμέρα_ἥμερος_
ἁμαρτῆσαι	verb_verb_	ἁμαρτέω_ἁμαρτάνω_
πολὲμου	verb_noun_	πολεμόω_πόλεμος_
συναφῇ	verb_noun_	συνάπτω_συναφή_
κόμη	noun_verb_verb_	κόμη_κομέω_κομάω_
μεγάλως	adjective_adverb_	μέγας_μεγάλως_
ἕο	pronoun_verb_	ἕ_ἵημι_
λέγοιτο	verb_verb_verb_	λέγω1_λέγω3_λέγω2_
μέσα	adjective_noun_noun_	μέσος_μέση_μέσης_
Διονύσιον	noun_adjective_	Διονύσιον_Διονύσιος_
κέντρου	verb_noun_	κεντρόω_κέντρον_
Ἐφύραν	verb_noun_	φυράω_Ἐφύρα_
Ἀλεκτρυόνος	noun_noun_	Ἀλεκτρυών_ἀλεκτρυών_
εἵατο	verb_verb_verb_verb_	ἕννυμι_ἕζομαι_ἧμαι_ἵημι_
κυλλοπόδιον	noun_noun_	Κυλλοποδίων_κυλλοποδίων_
λίσσεθ'	verb_verb_	λίσσομαι_λίζω_
Μακεδονίαν	noun_adjective_	Μακεδονία_Μακεδ́νιος_
τελέως	verb_adjective_	τελειόω_τέλειος_
φθάσαντα	verb_verb_	φθάνω_φθάζω_
δείπνου	noun_noun_	δεῖπνον_δεῖπνος_
ὑπερβατὸν	adjective_noun_	ὑπερβατός_ὑπερβατόν_
ἀκὴν	adverb_noun_	ἀκήν_ἀκή_
ὁρμᾶτε	verb_verb_	ὁρμάζω_ὁρμάω_
πεδίων	noun_verb_noun_	πεδίον_πεδάω_πέδιον_
κυρίου	verb_noun_	κυριόω_κύριος_
ἀνεπίδησεν	verb_verb_verb_verb_ἐπί-ἰδέ_	ἀνά-ἐπιδέω2_ἀνά-ἐπιδέω_ἀνά-πιδάω_ἀνά-ἐπιδέω1_ἀνά_
ἀπειλῶν	noun_verb_verb_	ἀπειλή_ἀπειλέω_ἀπειλέω1_
πρήσαντες	verb_verb_	πίμπρημι_πρήθω_
Ἄμαξαν	noun_noun_	ἄμαξα_Ἄμαξα_
βουκολίοις	noun_verb_	βουκόλιον_βουκολέω_
χαλκοῦν	verb_adjective_adjective_	χαλκόω_χαλκοῦς_χάλκεος_
οὐρέα	noun_noun_	ὀρεύς_οὐρεύς_
νεκροί	adjective_verb_	νεκρός_νεκρόω_
μυθήσομαι	verb_verb_	μυθέομαι_μυθέω_
φυλάσσετε	verb_verb_	φυλάσσω_φυλάζω_
Μῆτις	noun_noun_noun_	Μῆτις_Μήτις_μῆτις_
λύει	verb_verb_	λυάω_λύω_
ἀξιώσει	verb_noun_	ἀξιόω_ἀξίωσις_
κοίλας	adjective_adjective_	κοῖλος_κόιλος_
κατάρατον	verb_adjective_	καταίρω_κατάρατος_
Φρίξον	verb_noun_	φρίζω_Φρίξος_
ἐπικρατεῖ	adjective_verb_	ἐπικρατής_ἐπικρατέω_
ὁρίοις	verb_adjective_noun_	ὁράω_ὅριος_ὅριον_
ἐπιμαρτυρεῖ	verb_verb_	ἐπιμαρτυρέω_ἐπιμαρτύρομαι_
καταρεόμεναι	verb_verb_verb_	καταράομαι_καταίρω_καταρρέω_
θέρεϊ	verb_noun_	θέρω_θέρος_
βάπτω	noun_verb_	βάπτης_βάπτω_
ὁμοκλήσας	verb_verb_	ὁμοκλέω_ὁμοκλάω_
κύων	verb_noun_	κύω_κύων_
Ἄρεα	adjective_noun_noun_noun_	Ἄρεος_Ἄρης_Ἄρις_ἄρος_
ἀέθλων	noun_noun_	ἆθλος_ἆθλον_
ᾤμωξεν	verb_verb_	οἰμώσσω_οἰμώζω_
ὑπερτέρην	adjective_adjective_	ὑπέρ_ὑπέρτερος_
Ἰξίων	noun_noun_noun_	ἰξίον_Ἴξιος_Ἰξίων_
ποίω	verb_verb_adjective_	ποιόω_ποιέω_ποῖος_
ἐλίσσετο	verb_verb_verb_	λίσσομαι_ἐλίσσω_ἑλίσσω_
οἴων	verb_adjective_	οἰάω_οἶος_
ἀντίον	verb_adjective_noun_	ἀντάω_ἀντίος_ἀντίον_
χειμάρρους	adjective_adjective_	χείμαρρος_χειμάρρους_
λασίοισι	verb_noun_adjective_verb_	λάζω_λάσιον_λάσιος_λανθάνω_
ἡγούμην	verb_verb_	ἁγέομαι_ἡγέομαι_
διδῶ	verb_verb_	δίδημι_δίδωμι_
ἀργοὺς	adjective_adjective_	ἀργός1_ἀργός2_
διΐστησι	verb_verb_	διιστάω_διίστημι_
ἡμιτόμου	adjective_noun_	ἡμίτομος_ἡμίτομον_
χέων	verb_verb_	χάω_χέω_
θρόνου	noun_noun_	θρόνον_θρόνος_
ἐναντιουμένων	ἀντί-ἱέ_verb_ἀντί-ἰόομα_ἀντί-ἰό_ἀνά-τίζ_verb_	ἐν_ἐν-ἀντιόομαι_ἐν_ἐν_ἐν_ἐν-ἐναντιόομαι_
ἄξεσθαι	verb_verb_	ἄγω_ἄγνυμι_
σείων	verb_adjective_adjective_	σείω_σεῖος_θεῖος1_
μήλου	noun_noun_	μῆλον2_μῆλον1_
μυῶν	verb_verb_noun_verb_	μυέω_μυάω_μῦς_μυόω_
πειρῶνται	verb_verb_verb_	πειράζω_ω_πειράω_
Μελπομένης	verb_noun_	μέλπω_Μελπομένη_
νόου	verb_noun_	νοόω_νόος_
ἄλλου	pronoun_adverb_	ἄλλος_ἄλλου_
περιειλεῖσθαι	verb_verb_	περιειλέω_περιείλω_
δίω	verb_adjective_	δίω_δῖος_
ὕπνον	noun_noun_	ὕπνον_ὕπνος_
μικρόν	adjective_adjective_	σμικρός_μικρός_
ἀλήμεναι	verb_verb_verb_	εἴλω_ἀλάομαι_ἀλέω_
ἡλίου	verb_noun_	ἡλιόω_ἥλιος_
ὁρμηθείς	verb_verb_	ὁρμάω_ὁρμέω_
ἀρεσκείας	noun_noun_	ἀρέσκεια_ἀρεσκεία_
λέξεις	noun_verb_verb_verb_	λέξις_λέγω2_λέγω1_λέγω3_
οὐτάμενος	verb_verb_	οὐτάω_οὐτάζω_
ἐφορμήσας	verb_verb_	ἐφορμάω_ἐφορμέω_
Ἑρμείω	noun_noun_	Ἑρμεῖον_Ἑρμῆς_
ἄριστα	adjective_noun_	ἄριστος_ἄριστον_
οὗς	preposition_noun_	εἰς_ὗς_
νοοῦμεν	verb_verb_	νοέω_νοόω_
ἐλέγετο	verb_verb_verb_	λέγω3_λέγω1_λέγω2_
ἔσκεπεν	verb_verb_	σκέπω_σκέπτομαι_
Ὑρίη	noun_noun_	Ὑρίη_Ὑρίευς_
Πολίτῃ	noun_noun_	Πολίτης_πολίτης_
τὼ	adverb_article_	τῷ_ὁ_
θεασάμενος	verb_verb_	θεάομαι_θεάω_
κοῖλα	adjective_adjective_	κοῖλος_κόιλος_
ἥττων	verb_adjective_	ἡττάω_ἥσσων_
βοῇ	verb_noun_noun_adjective_	βοάω_βοή_βοεύς_βόειος_
Ἀλεός	noun_adjective_	Ἀλεός_ἀλεός_
ἐξοῦ	verb_verb_	ἐξίημι_ξέω_
ἐπιπτέσθαι	verb_verb_	ἐφίπταμαι_ἐπιπίπτω_
γηράσασαν	verb_verb_	γηράσκω_γηράω_
ὑποδεξία	noun_adjective_	ὑποδεξίη_ὑποδέξιος_
ᾗσι	verb_pronoun_	ἵημι_ὅς_
λίθους	verb_noun_verb_	λιθόω_λίθος_λιθόομαι_
λόπον	noun_noun_	λοπός_λόπος_
πολέμιον	adjective_verb_	πολέμιος_πολεμέω_
ῥινὸν	noun_noun_	ῥινόν_ῥινός_
τελείους	adjective_verb_	τέλειος_τελειόω_
ταὐτῷ	adjective_verb_	ταὐτός_ταὐτάζω_
ἀμβροσίῃ	adjective_noun_noun_	ἀμβρόσιος_ἀμβροσίη_ἀμβροσία_
ἀρῆς	verb_noun_noun_verb_	ἀράζω_ἀρά_ἀρή_ἀείρω_
πινυτὴν	adjective_noun_	πινυτός_πινυτή_
ἀκέων	noun_adjective_verb_noun_	ἀκή_ἀκέων_ἀκέω_ἄκος_
πένθει	verb_noun_	πενθέω_πένθος_
γενῶν	noun_noun_	γενή_γένος_
θρασεῖς	verb_adjective_	θράζω_θρασύς_
μορφῆς	verb_verb_noun_	μορφάζω_μορφάω_μορφή_
Ἀριστάρχῳ	noun_noun_	ἀρίσταρχος_Ἀρίσταρχος_
θυμοῦ	noun_verb_	θυμός_θυμόω_
λοιπὰ	adjective_noun_	λοιπός_λοιπάς_
μαντευόμενος	verb_verb_	μαντεύω_μαντεύομαι_
κάλλιστα	adjective_adverb_	καλός_κάλλιστα_
Ἀττικά	noun_adjective_	Ἀττική_Ἀττικός_
σφῶν	pronoun_verb_adjective_	σφεῖς_σφάζω_σφός_
γράφει	noun_verb_	γράφος_γράφω_
χειμῶν	verb_verb_verb_	χειμάω_χειμέω_χειμάζω_
Μήδεια	noun_adjective_	Μήδεια_Μήδειος_
θείου	noun_verb_adjective_	θεῖος2_θειόω_θεῖος1_
νηῶν	noun_verb_noun_	ναός_νηέω_ναῦς_
διορθώσεις	noun_verb_	διόρθωσις_διορθόω_
Ἑλίκην	noun_noun_	Ἑλίκη_ἑλίκη_
ἔξοδον	noun_adjective_	ἔξοδος1_ἔξοδος2_
ἁμαρτῇ	verb_adverb_	ἁμαρτέω_ἁμαρτῆ_
ί̈δον	noun_noun_	ιδος_ίδος_
νεωτέραν	adjective_adjective_	νέος_νεώτερος_
κομήτην	verb_noun_	κομάω_κομήτης_
σκότιον	adjective_verb_	σκότιος_σκοτάω_
Τερψιχόρης	adjective_noun_	τερψίχορος_Τερψιχόρη_
ἐπαρθέντα	verb_verb_	ἐπαίρω_ἐπαραρίσκω_
μιμητὴν	adjective_noun_	μιμητός_μιμητής_
τιμῇ	verb_noun_verb_	τιμάω_τιμή_τιμέω_
ῥῶ	verb_verb_	ῥάζω_ῥαίνω_
ὑπάρχω	noun_verb_	ὕπαρχος_ὑπάρχω_
μειλιχίᾳ	adjective_noun_	μειλίχιος_μειλιχία_
εὐθὺς	adverb_adjective_	εὐθύς2_εὐθύς1_
πάρεισι	verb_verb_	πάρειμι1_πάρειμι2_
νήσων	noun_verb_verb_	νῆσος_νέω2_νέω_
Νότοιο	noun_noun_	νότος_Νότος_
χέρσω	verb_noun_	χερσόω_χέρσος_
κακῷ	verb_adjective_	κακάζω_κακός_
ἐντίμων	adjective_verb_	ἔντιμος_ἐντιμάω_
ἱερῆς	adjective_verb_noun_noun_	ἱερός_ἱεράζω_ἱερή_ἱερά_
Θησεῖ	verb_noun_	τίθημι_Θησεύς_
ἀμβροσίας	noun_adjective_noun_	ἀμβροσίη_ἀμβρόσιος_ἀμβροσία_
πύθηαι	verb_verb_	πύθω_πυνθάνομαι_
λεγόντων	verb_verb_verb_	λέγω1_λέγω3_λέγω2_
Ἔρις	noun_noun_	Ἔρις_ἔρις_
ἠλιθίως	verb_adjective_	ἠλιθιόω_ἠλίθιος_
κελεῦσαι	verb_verb_	κέλλω_κελεύω_
τοῖσι	article_irregular_	ὁ_τίς_
ἅλιον	noun_adjective_adjective_	ἥλιος_ἅλιος2_ἅλιος1_
κρείσσω	verb_adjective_	κρεισσόω_κρείσσων_
ὅλης	adjective_verb_adjective_	ὅλοξ_ὁλάω_ὅλος_
πυρός	noun_noun_	πυρός_πῦρ_
νεωτέρων	adjective_adjective_	νεώτερος_νέος_
μεταμάζιον	adjective_adverb_	μεταμάζιος_μεταμάζιον_
Πυλίοις	adjective_noun_	Πύλιος_Πύλιοι_
ὑπαντιάσας	verb_verb_	ὑπαντιάζω_ὑπαντιάω_
ἀναλώσαντες	verb_verb_	ἀναλόω_ἀναλίσκω_
Δαναοὺς	noun_noun_	Δαναοί_Δαναός_
οἰήσεταί	verb_verb_	οἰάω_οἴομαι_
θυόμενα	verb_verb_	θύω2_θύω1_
ἱμάντων	verb_noun_	ἱμαντόω_ἱμάς_
Διοσκούρων	noun_noun_	Διόσκουροι_Διόσκοροι_
ὑποκρίσει	noun_verb_	ὑπόκρισις_ὑποκρίζω_
κοῦροι	noun_noun_	κοῦρος_κόρος2_
ζωῆς	noun_adjective_	ζωή_ζωός_
σιωπῇ	noun_verb_	σιωπή_σιωπάω_
φωτί	noun_noun_	φώς_φάος_
Νηλέα	noun_adjective_	Νηλεύς_νηλής_
πλεῖαί	adjective_verb_	πλέως_πλέω_
πίθοιο	verb_noun_	πείθω_πίθος_
ἐπιτίμιον	noun_adjective_	ἐπιτίμιον_ἐπιτίμιος_
ζῴῳ	noun_noun_	ζῷον_ζώιον_
ἤθει	noun_verb_	ἦθος_ἠθέω_
θεῖον	noun_verb_adjective_	θεῖος2_θέω_θεῖος1_
ξυνήϊον	verb_adjective_	σύνειμι2_ξυνήιος_
μάτην	noun_verb_adverb_noun_	μάτη_ματάω_μάτην_μάτος_
τετρώρω	adjective_adjective_noun_	τετράορος_τέτρωρος_τέτρωρον_
λεγώμεθα	verb_verb_verb_	λέγω3_λέγω2_λέγω1_
Κυθήρων	noun_noun_	Κύθηρος_Κύθηρα_
ἔλεγον	verb_verb_noun_verb_	λέγω1_λέγω2_ἔλεγος_λέγω3_
Ἴδη	noun_verb_noun_noun_noun_	ἶδος_ἰδέω_Ἴδη_Ἴδης_ἴδη_
ξυνήϊα	verb_adjective_	σύνειμι2_ξυνήιος_
ὁπλῇ	noun_verb_	ὁπλή_ὁπλέω_
ἀκουσίῳ	adjective_adjective_	ἀκούσιος_ἀεκούσιος_
ἐρήμω	verb_adjective_	ἐρημόω_ἐρῆμος_
καρπόν	noun_noun_	καρπός2_καρπός1_
Ἥλιε	noun_noun_	ἥλιος_Ἥλιος_
λεχεποίην	noun_noun_	λεχεποίη_λεχεποίης_
μηνίσαντος	verb_verb_	μηνίω_μηνίζω_
ξηράς	noun_adjective_	ξηρά_ξηρός_
μεταχειρίζεται	verb_verb_	μεταχειρίζομαι_μεταχειρίζω_
χρωμένων	verb_verb_verb_verb_	χράομαι_χράω2_χράω1_χραύω_
οὖσα	verb_noun_	εἰμί_οὖσον_
χειρῶν	verb_noun_	χειρόω_χείρ_
σωλῆνος	noun_noun_	σωλήν_σωλῆνος_
πολυάνδριον	noun_noun_adjective_verb_	πολυανδρεῖον_πολυάνδριον_πολυάνδριος_πολυανδρέω_
Γῆς	noun_noun_	γῆ_Γαῖα_
μηνῶν	noun_noun_	μήνη_μείς_
Χάριτας	noun_noun_	χάρις_Χάρις_
ἑῇ	adjective_verb_	ἑός_ἵημι_
εὐφροσύνη	adjective_noun_	εὐφρόσυνος_εὐφροσύνη_
ψιλῶς	noun_adjective_verb_	ψιλεύς_ψιλός_ψιλόω_
ἀγαπωμένῳ	verb_verb_	ἀγαπάω_ἀγαπάζω_
ἐγχείῃσι	noun_verb_	ἐγχείη_ἐγχύνω_
Περσεφόνης	noun_noun_	Περσεφόνη_Φερσέφασσα_
Κισσῆς	verb_noun_	κισσάω_Κισσῆς_
αἰτίᾳ	adjective_noun_	αἴτιος_αἰτία_
νέαν	adjective_verb_noun_	νέος_νεάω_νέα_
δοκῶσιν	verb_noun_verb_verb_	δοκόω_δοκώ_δοκέω_δοκάζω_
ὀπίσω	adverb_verb_	ὀπίσω_ὀπίζω_
ἐίσην	adjective_adjective_	ἴσος_ἔισος_
ὑγρῶν	verb_adjective_	ὑγράζω_ὑγρός_
ἀπαντῶν	noun_verb_	ἀπαντή_ἀπαντάω_
ᾤκει	verb_verb_verb_	οἰκέω_ὀίζω_ὠίζω_
τρέφει	verb_noun_	τρέφω_τρέφος_
ἐνδεῖν	verb_verb_verb_	ἐνδέω2_ἐνδέω_ἐνδέω1_
συντετμημένως	adverb_verb_	συντετμημένως_συντέμνω_
φάρμακον	noun_noun_	φάρμακος_φάρμακον_
Μακεδονίας	noun_adjective_	Μακεδονία_Μακεδ́νιος_
σφενδόνης	noun_verb_	σφενδόνη_σφενδονάω_
παρηωρημένος	verb_verb_	παρά-ἀωρέω_παρά-ἐωρέω_
κοινῶν	verb_adjective_	κοινόω_κοινός_
ἔθυον	verb_verb_	θύω2_θύω1_
ἐπέλοντο	verb_verb_	ἐφαιρέομαι_πέλω_
κατωτάτην	adjective_adjective_	κατώτατος_κάτος_
πλάσῃ	noun_verb_	πλάσις_πλάσσω_
πᾶσαι	verb_adjective_	πάομαι_πᾶς_
πυρήν	noun_noun_	πυρήν_πυρή_
μαχησόμεθα	verb_verb_verb_verb_verb_	συμμαχέω_μαχέω_συμ́ω_μαχάω_μάχομαι_
ᾠδῆς	noun_noun_	ᾠδή_ἀοιδή_
ἴσως	adjective_verb_adverb_	ἴσος_ἰσόω_ἴσως_
προβάτων	verb_noun_	προβαίνω_πρόβατον_
ταύτῃ	pronoun_adverb_	οὗτος_ταύτῃ_
φυλακῆς	noun_noun_	φυλακή_φυλακεύς_
κριτῇ	noun_adjective_	κριτής_κριτός_
ζῶον	verb_verb_	ζώω_ζάω_
καθεζόμενος	verb_verb_	κατά-καθέζομαι_κατά-ἕζομαι_
ἐπιθυμία	verb_noun_	ἐπιθυμιάω_ἐπιθυμία_
οὑτός	adjective_adverb_	ἑτός_ἐτός_
ῥοὰς	noun_noun_	ῥοή_ῥοάς_
λοιπῶν	verb_adjective_	λοιπάζω_λοιπός_
οἰκήσει	verb_noun_	οἰκέω_οἴκησις_
ἀείρω	verb_adjective_	ἀείρω_ἄειρος_
δείπνῳ	noun_noun_	δεῖπνος_δεῖπνον_
φάτ'	noun_verb_noun_	φάτης_φημί_φάτις_
Ἀλεξίων	noun_verb_noun_	ἀλέξιον_ἀλέξω_ἄλεξις_
σύνθετον	adjective_verb_	σύνθετος_συντίθημι_
ἀρίστην	verb_adjective_	ἀριστάω_ἄριστος_
Καλήτωρ	noun_noun_	καλήτωρ_Καλήτωρ_
κατακτάμεναι	verb_verb_	κατακτείνω_κατακτάομαι_
ἀπριάτην	adverb_adjective_	ἀπριάτην_ἀπρίατος_
πλάνη	noun_verb_	πλάνη_πλανάω_
ἀπηλγημένως	adverb_verb_	ἀπηλγημένως_ἀπαλγέω_
ἀρετῆς	verb_noun_	ἀρετάω_ἀρετή_
βίας	noun_verb_	βία_βιάω_
Νηλεῖ	adjective_noun_	νηλής_Νηλεύς_
μυθησαίμην	verb_verb_	μυθέω_μυθέομαι_
ὅτε	pronoun_conjunction_	ὅστε_ὅτε_
πρέποντας	verb_noun_	πρέπω_πρέπων_
ἔρως	noun_noun_	ἔρως_ἔρος1_
Ξένιος	adjective_noun_	ξένιος_Ξένιος_
ἐπίσταται	noun_verb_verb_	ἐπιστάτη_ἐπίσταμαι_ἐφίστημι_
Ἅλιος	noun_noun_adjective_adjective_noun_	Ἅλιος_ἥλιος_ἅλιος2_ἅλιος1_Ἅλις_
θυσιῶν	noun_verb_	θυσία_θυσιάζω_
ἀκεσταί	noun_adjective_	ἀκεστής_ἀκεστός_
ἔγημεν	verb_verb_	γαμέω_ἔσσομαι_
Ἄρεως	noun_noun_noun_	Ἄρις_Ἄρευς_Ἄρης_
Διδύμου	adjective_noun_	δίδυμος_Δίδυμος_
τῶι	adverb_irregular_pronoun_article_	τῷ_τίς_τις_ὁ_
ἔμπεδα	adjective_adverb_	ἔμπεδος_ἔμπεδα_
ἀήτης	noun_noun_	ἀήτης_ἀήτη_
βούλησιν	verb_noun_	βούλομαι_βούλησις_
ῥηϊδίως	adjective_adjective_	ῥᾴδιος_ῥῄδιος_
ὑπήκοόν	noun_adjective_adjective_	ὑπήκοον_ὑπήκους_ὑπήκοος_
οἰῶν	noun_noun_verb_	οἴη_ὄις_οἰάω_
κρεμάμενον	verb_verb_verb_	κρεμάζω_κρεμάννυμι_κρεμάω_
ὁρμῆς	verb_noun_verb_verb_	ὁρμάω_ὁρμή_ὁρμέω_ὁρμάζω_
ς᾽	pronoun_adjective_	σύ_σός_
οὐτάμενοι	verb_verb_	οὐτάζω_οὐτάω_
πληγῶν	noun_noun_	πλήξ_πληγή_
ἐτράπη	verb_verb_verb_	τέρπω_τραπέω_τρέπω_
ἄσῃ	noun_verb_noun_	ἄσις_ἄω3_ἄση_
ἰόντι	verb_verb_	εἰμί_εἶμι_
Μενάνδροιο	noun_adjective_	Μένανδρος_μένανδρος_
ἀπορούσης	verb_verb_	ἀφοράω_ἀπορέω_
παρειὰς	noun_noun_	παρειάς_παρειά_
ἀνανεῦσαι	verb_verb_	ἀνανεύω_ἀνανέω_
Ἀσίας	adjective_adjective_noun_noun_	Ἄσιος_ἄσιος_Ἀσία_Ἀσίας_
τίσειεν	verb_verb_	τίνω_τίζω_
ἑκατέρως	adverb_adjective_	ἑκατέρως_ἑκάτερος_
ὄμβρον	noun_noun_	ὄμβρος_ὄμβρος_
πλαγίους	adjective_verb_	πλάγιος_πλαγιόω_
ἄτῶ	adjective_adjective_	ἆτος_ἄατος_
χαλκείω	adjective_noun_	χάλκειος_χαλκεῖον_
χαλκῆ	adjective_adjective_noun_	χάλκεος_χαλκοῦς_χαλκεύς_
μαχήσεται	verb_verb_verb_verb_verb_	συμ́ω_μαχάω_μαχέω_μάχομαι_συμμαχέω_
πεινῶντι	verb_verb_	πεινέω_πεινάω_
κεῖτο	verb_verb_	κέω_κεῖμαι_
μελῶν	noun_noun_	μέλος_μέλη_
Φιλητὰ	adjective_noun_	φιλητός_φιλητής_
συνθέτω	adjective_verb_noun_	σύνθετος_συντίθημι_συνθέτης_
εἴδετ'	verb_verb_verb_	εἶδον_εἴδομαι_οἶδα_
Ἀριστάρχoυ	noun_noun_	Ἀρίσταρχος_ἀρίσταρχος_
χαλκῷ	noun_adjective_	χαλκοῦς_χάλκεος_
Αἴθρη	noun_noun_	Αἴθρη_αἴθρη_
Ἐπειοὶ	adjective_adjective_	Ἐπειοί_Ἐπειός_
συμφορᾶς	verb_noun_noun_	συμφοράζω_συμφορεύς_συμφορά_
ἀπειλοῦντος	verb_verb_verb_	ἀπειλέω1_ἀπειλέω_ἀπειλέω2_
ζωιδίων	noun_noun_	ζῴδιον_ζωίδιον_
πηγάς	noun_adjective_noun_	πηγάς_πηγός_πηγή_
ἔνθεο	verb_verb_	ἔρχομαι_ἐντίθημι_
Ἐφέσιος	adjective_noun_	Ἐφέσιος_ἔφεσις_
ἀναδιπλώσει	verb_noun_verb_	ἀναδιπλόω_ἀναδίπλωσις_ἀναδιπλόομαι_
σθένει	verb_noun_	σθένω_σθένος_
Ἀρηϊθόου	noun_adjective_	Ἀρηΐθοος_Ἀρηίθοος_
Κάστωρ	noun_noun_	κάστωρ_Κάστωρ_
ἴδοιεν	verb_verb_	ἰδέω_εἶδον_
ἦρχθαι	verb_verb_	ἄρχω_ἔργω1_
Ἱπποδάμεια	noun_noun_	Ἱπποδάμεια_Ἱπποδάμειον_
καθαρσίων	noun_adjective_	κάθαρσις_καθάρσιος_
Δημήτριος	adjective_noun_	Δημήτριος_Δημ́ητριος_
ἀρείους	adjective_adjective_	ἀρείων_ἄρειος_
εἴδετε	verb_verb_	οἶδα_εἶδον_
ἰάσατο	verb_verb_	ἰάζω_ἰάομαι_
Φθίαν	noun_adjective_noun_adjective_	φθία_φθῖος_Φθία_Φθῖος_
ἄκοντας	noun_adjective_	ἄκων_ἀέκων_
πλοῦτος	noun_noun_	πλοῦτος2_πλοῦτος1_
μελαινέων	noun_adjective_	μέλαινα_μέλας_
παρὼν	noun_verb_	παρών_πάρειμι1_
παραίτιος	adjective_adjective_	παραίτιος_παραιτητής_
τραυματίαν	noun_noun_	τραυματίας_τραυματίης_
Λαπίθου	noun_noun_	Λαπίθης_Λάπιθος_
προσφωνήσεις	noun_verb_	προσφώνησις_προσφωνέω_
σαωσέμεν	verb_verb_	σώζω_σαόω_
χρήσεις	verb_noun_	χράω2_χρῆσις_
δεσμοῖς	verb_noun_verb_	δεσμέω_δεσμός_δεσμεύω_
ἰκτίνῳ	noun_noun_	ἰκτῖνος_ἴκτινος_
ῥύσια	adjective_noun_	ῥύσιος_ῥύσιον_
πύργου	noun_verb_	πύργος_πυργόω_
ὁρμῇ	verb_verb_noun_verb_	ὁρμέω_ὁρμάω_ὁρμή_ὁρμάζω_
παρὸν	adjective_verb_	πηρός_πάρειμι1_
Λιτή	noun_adjective_	λιτή_λιτός_
ἀποπειρᾶται	verb_verb_	ἀποπειράζω_ἀποπειράομαι_
δόξας	verb_noun_	δοκέω_δόξα_
ἔγχους	verb_noun_	ἐγχόω_ἔγχος_
ζόφου	verb_noun_	ζοφόω_ζόφος_
χωρήσει	verb_noun_	χωρέω_χώρησις_
συνεφώρμησεν	verb_verb_	σύν-ἐφορμέω_σύν-ἐφορμάω_
θεωρῶν	noun_verb_	θεωρός_θεωρέω_
φυλάξαι	verb_verb_	φυλάζω_φυλάσσω_
δεομένων	verb_verb_verb_	δέω2_δέομαι_δέω1_
βῶν	noun_verb_	βοῦς_βάζω_
οὖλος	adjective_adjective_adjective_adjective_adjective_	οὖλος2_οὐοὖος2_οὖλος3_οὖλονς1_ὅλοξ_
ἠρήσαντο	verb_verb_verb_verb_verb_	ἀρέομαι_ἀράομαι_ἐρέομαι_ἐρέω_ἐράομαι_
θύμως	noun_verb_	θύμος_θυμόω_
Δεῖμον	verb_noun_	δέμω_Δεῖμος_
βροτοὶ	verb_noun_	βροτόομαι_βροτός_
τοῖ	particle_pronoun_	τοι_σύ_
Αἴθων	verb_noun_adjective_noun_noun_	αἴθω_Αἴθων_αἴθων_αἶθος_αἰθος_
ἠπείλει	verb_verb_verb_	ἀπειλέω2_ἀπειλέω_ἐπειλέω_
ἐλάσσων	verb_verb_adjective_	ἐλασσόω_ἐλαύνω_ἐλάσσων_
σφυρῶν	noun_noun_	σφυρόν_σφῦρα_
ἷκεν	verb_verb_	ἱκνέομαι_ἵκω_
νήφων	noun_verb_	νήφων_νήφω_
ἐβόων	verb_verb_	βοόω_βοάω_
ἀποδείξῃ	noun_verb_	ἀπόδειξις_ἀποδείκνυμι_
ἄγαν	verb_noun_adverb_	ἀγάω_ἄγη_ἄγαν_
δεσμοί	noun_verb_	δεσμός_δεσμεύω_
ὑπερβατῶν	adjective_noun_	ὑπερβατός_ὑπερβατόν_
ἄγριον	adjective_verb_	ἄγριος_ἀγρέω_
τροφοῦ	noun_verb_verb_	τροφός_τρέφω_τροφέω_
ἡμέρᾳ	noun_adjective_	ἡμέρα_ἥμερος_
κρημνοῖς	verb_noun_	κρημνάω_κρημνός_
ἐρρεῖτο	verb_verb_	ῥέομαι_ῥέω_
λέγεις	verb_verb_verb_	λέγω3_λέγω1_λέγω2_
κοίλοις	adjective_adjective_	κοῖλος_κόιλος_
ἄγονον	adjective_noun_	ἄγονος_ἄγονον_
καρπὸς	noun_noun_	καρπός2_καρπός1_
ἔνθ'	verb_verb_adverb_	εἰμί_ἔρχομαι_ἔνθα_
ἀνέκλων	ἐκ-λάω_verb_	ἀνά_ἀνά-κλάω_
γραφὴν	noun_noun_	γραφής_γραφή_
ἤχει	verb_verb_	ἠχέω_ἄγω_
Λᾶς	verb_noun_verb_verb_	λάζω_Λᾶς_λάω1_λάω2_
πότε	particle_noun_noun_	ποτέ_πότε_πότος_
Θρόνιον	noun_noun_noun_	θρόνιον_Θρόνιος_Θρόνιον_
Σπάρτη	noun_noun_	Σπάρτη_σπάρτη_
ἔκτισε	verb_verb_	κτίζω_ἐκτίνω_
δεξαμένῳ	verb_verb_	δείκνυμι_δέχομαι_
μύει	verb_verb_verb_	μύω_μυέω_μυάω_
ἔλεγε	verb_verb_noun_verb_	λέγω2_λέγω1_ἔλεγος_λέγω3_
Ἐφύρη	noun_verb_verb_	Ἐφύρα_φύρω_φυράω_
στᾶσι	verb_verb_	στάζω_ἵστημι_
περικεφαλαίαις	noun_adjective_	περικεφαλαία_περικεφάλαιος_
ἄνετον	verb_verb_adjective_	ἄνω1_ἀνίημι_ἄνετος_
οἶσθ'	noun_adjective_verb_	ὀιστός_οἰστός_οἶδα_
ἀνθιστάμενα	verb_verb_	ἀνθιστάω_ἀνθίστημι_
τιμήσειαν	verb_verb_	τιμέω_τιμάω_
ὄμβρων	noun_verb_noun_	ὄμβρος_ὀμβρόω_ὄμβρος_
Αἰτωλίας	adjective_noun_noun_	Αἰτώλιος_Αἰτωλίη_Αἰτωλία_
προσιέναι	verb_verb_	πρόσειμι1_προσίημι_
χρῆται	verb_verb_verb_verb_	χραύω_χράω1_χράω2_χράομαι_
ἔν	preposition_verb_preposition_	εἰς_εἰμί_ἐν_
χαζώμεθ'	verb_verb_	χάζω_χάζομαι_
ἀορίστου	verb_adjective_	ἀοριστόω_ἀόριστος_
ἀπεχώμεθα	verb_verb_	ἀπέχω_ἀποχώννυμι_
ὣν	preposition_conjunction_particle_conjunction_	ἀνά_ἄν2_ἄν1_ἐάν_
υἱοῖς	noun_verb_	υἱός_υἱόω_
σημείων	verb_noun_	σημειόω_σημεῖον_
βάλλει	verb_noun_	βάλλω_βάλλις_
ἡμῶν	adjective_pronoun_	ἡμός_ἐγώ_
φήνας	verb_noun_	φαίνω_φήνη_
κοινοῦ	verb_adjective_	κοινόω_κοινός_
ἄνακτ'	verb_noun_verb_	ἀνάζω_ἄναξ_ἀνάσσω_
εἵρηται	verb_verb_verb_verb_	εἴρω_ἔρομαι_εἴρω2_ἐρῶ_
ἁρμόσει	noun_verb_	ἅρμοσις_ἁρμόζω_
ἐροῦ	verb_verb_verb_verb_verb_	ἔρομαι_ῥέομαι_ἐρέω_ἐράομαι_ἐρέομαι_
ἀρὰν	noun_noun_	ἀρά_ἀρή_
ἐπικλειομένους	verb_verb_	ἐπικλείω2_ἐπικλείω1_
ἀπιοῦσι	verb_verb_	ἄπειμι1_ἄπειμι2_
ἰών	verb_verb_	εἰμί_εἶμι_
πεφήσεται	verb_verb_	πέσσω_φαίνω_
ἔτας	noun_noun_	ἔται_ἔτης_
διωρίσατο	verb_verb_verb_	διά-ὡρίζω_διά-ὠρίζω_διά-ὁρίζω_
θεία	noun_adjective_	θεία_θεῖος1_
Θεσσαλίας	noun_noun_	Θεσσαλίη_Θεσσαλία_
βοείας	noun_adjective_	βοείη_βόειος_
Ἀττικῶν	adjective_noun_	Ἀττικός_Ἀττική_
πρώτω	adjective_adjective_	πρῶτος_πρότερος_
ὄργανον	noun_adjective_verb_	ὄργανον_ὄργανος_ὀργαίνω_
ἐγχείῃ	noun_verb_	ἐγχείη_ἐγχύνω_
Ἀρείῳ	adjective_noun_adjective_	ἄρειος_Ἀρεῖος_Ἄρειος_
αἰκισθῆναι	verb_verb_	αἰκίζω_αἰκίζομαι_
ἔμ'	pronoun_adjective_	ἐγώ_ἐμός_
χαλάζῃ	noun_verb_	χάλαζα_χαλάω_
δείσας	noun_verb_	δεῖσα_δείδω_
ἐντελῆς	verb_verb_adjective_	ἐντελέω_ἐντέλλω_ἐντελής_
ἀσθενεῖς	adjective_verb_	ἀσθενής_ἀσθενέω_
ἀρσενικοῖς	noun_adjective_	ἀρσενικόν_ἀρσενικός_
ἔκλεψεν	verb_verb_	ἐκλέπω_κλέπτω_
ὤρεσσι	noun_noun_	ὄαρ_ὦρος_
ἔχη	verb_verb_noun_	χέω_χάω_ἔχις_
ὑπερέβη	verb_verb_	ὑπερβαίνω_ὑπερέπτω_
σφὼ	pronoun_pronoun_adjective_	σφεῖς_σύ_σφός_
ἀπήχησιν	verb_noun_	ἀπάγω_ἀπήχησις_
καταπέψη	verb_verb_ἀπό-ἑψέ_ἀπό-ἑψά_ἀπό-ψέ_	κατά-ἀφέψω_κατά-ἀποψάω_κατά_κατά_κατά_
οὔτι	pronoun_adverb_	οὔτις_οὔτι_
οὔλων	adjective_adjective_adjective_adjective_	οῦλος2_ὅλοξ_οὖλονς1_οὖλος3_
Φρίξω	noun_verb_verb_noun_	φρῖξος_φρίσσω_φρίζω_Φρίξος_
ἀλαλαγμοῦ	noun_noun_	ἀλαλαγή_ἀλαλαγμός_
ἐξερέω	verb_verb_	ἐξεράω_ἐξερέω_
πρῆσεν	verb_verb_	πίμπρημι_πρήθω_
υἱῶ	noun_verb_	υἱός_υἱόω_
Λαπιθῶν	noun_noun_	Λαπίθης_Λαπίθαι_
ἐπαΐξαι	verb_verb_	ἐπᾴσσω_ἐπαίσσω_
ἔγγιστα	adjective_adjective_	ἔγγιστος_ἐγγίων_
βίῃ	verb_noun_	βιόω_βία_
μύθ'	noun_noun_	μύτης_μύτις_
κάρα	noun_noun_noun_	κάρα_κάρρον_κάρ_
ωὔλιον	adjective_noun_verb_	αὔλιος_αὔλιον_αὐλέω_
ξυνδῆσαι	verb_verb_	συνδέομαι_συνδέω_
ποιῶν	verb_adjective_verb_noun_	ποιόω_ποιός_ποιέω_πόα_
βραχέων	noun_adjective_	βράχεα_βραχύς_
ἰδίων	noun_adjective_verb_verb_	ἶδος_ἴδιος_ἰδίω_ἰδέω_
Ἄρης	noun_noun_	Ἄρης_Ἄρις_
εὐδίαν	verb_noun_	εὐδιάω_εὐδία_
Ἰφιγένειαν	noun_noun_noun_	Ἰφίγενεια_Ἰφιγένεια_Ἰφιγενεία_
σιδήρου	verb_noun_noun_	σιδηρόω_σίδηρος_σίδηρον_
ἀναγκαίῃ	noun_adjective_noun_	ἀναγκαίη_ἀναγκαῖος_ἀνάγκη_
ἄρσην	noun_noun_noun_	ἄρσος_ἄρσης_ἄρσην_
τρώσῃ	noun_verb_	τρῶσις_τιτρώσκω_
τίσασθαι	verb_verb_	τίνω_τίζω_
τιμώμενον	verb_verb_	τιμόω_τιμάω_
Κρητικὸν	noun_adjective_	Κρητικόν_Κρητικός_
ἄκρην	noun_adjective_	ἄκρα_ἄκρος_
ῥύπα	verb_noun_	ῥυπάω_ῥύπον_
φανεροῦ	verb_adjective_	φανερόω_φανερός_
ἀρίστων	verb_noun_adjective_	ἀριστάω_ἄριστον_ἄριστος_
Ἠελίῳ	noun_noun_noun_	Ἥλιος_ἠέλιος_ἥλιος_
Θεσσαλίαν	noun_noun_	Θεσσαλίη_Θεσσαλία_
αἰχμῆς	verb_noun_	αἰχμάζω_αἰχμή_
ἐναντιόν	ἀντί-εἶμ_ἀντί-εἰμ_	ἐν_ἐν_
φιλοφροσύνην	adjective_noun_adjective_	φιλόφρων_φιλοφροσύνη_φιλοφρόσυνος_
εἰλῶν	verb_noun_noun_verb_	εἴλω_ἴλη_εἴλη_εἰλέω_
ἀπιόντα	verb_verb_	ἄπειμι1_ἄπειμι2_
τριχῶν	verb_noun_	τριχόω_θρίξ_
πέπλω	adjective_noun_	πεπλος_πέπλος_
τρία	noun_numeral_	τρία_τρεῖς_
ἑῶ	verb_adjective_	ἵημι_ἑός_
οἱ̄	article_pronoun_	ὁ_ἕ_
γόου	verb_noun_	γοάω_γόος_
ἔπεσεν	verb_verb_verb_	ἐφέζομαι_ἐπιέννυμι_πίπτω_
μηδαμῶς	adjective_adverb_	μηδαμός_μηδαμῶς_
λίθων	verb_noun_	λιθάω_λίθος_
ὄζω	noun_verb_	ὄζος_ὄζω_
λείψουσι	verb_verb_	λείπω_λείβω_
ἧ	article_adverb_	ὁ_ἧ_
πεξαμένη	verb_verb_	πέσσω_πέκω_
ἀνεδέξατο	verb_verb_	ἀναδέχομαι_ἀναδείκνυμι_
δαῖε	verb_verb_	δαίω2_δαίω1_
σοῖ	verb_pronoun_	σέω_σύ_
κόρη	verb_noun_	κορέω_κόρη_
ἐρέριπτο	verb_verb_	ἐρείπω_ῥίπτω_
Σινωπική	noun_adjective_	Σινωπική_Σινωπικός_
ζωὴ	noun_adjective_	ζωή_ζωός_
θᾶσσον	adjective_adjective_	θάσσων_ταχύς_
ἔχῃ	verb_noun_	ἔχω_ἔχις_
ἔστε	verb_conjunction_	εἰμί_ἔστε_
γῇ	noun_noun_	Γαῖα_γῆ_
θύμω	verb_noun_noun_	θυμόω_θύμος_θύμον_
ἠράσθησαν	verb_verb_	ἀράζω_ἔραμαι_
λαμπάδες	noun_noun_	λαμπάς1_λαμπάς2_
ἄπεισι	verb_verb_	ἄπειμι2_ἄπειμι1_
ἄν	particle_preposition_conjunction_conjunction_	ἄν1_ἀνά_ἐάν_ἄν2_
ἐλέγομεν	verb_verb_verb_	λέγω3_λέγω2_λέγω1_
χάρμης	noun_noun_	χάρμης_χάρμη_
ὀλιγοχρόνιον	verb_adjective_	ὀλιγοχρονέω_ὀλιγοχρόνιος_
τὰ	irregular_article_	τίς_ὁ_
Δαναοὶ	noun_noun_	Δαναός_Δαναοί_
ἀπαλλαγήσεσθαι	verb_verb_	ἀπαλλάσσω_ἀπαλλαξείω_
ἄδιψον	noun_adjective_	ἄδιψον_ἄδιψος_
ἄκρᾳ	noun_adjective_	ἄκρα_ἄκρος_
ὁμοίαν	adjective_adjective_	ὁμοῖος_ὅμοιος_
ἀστρολόγος	adjective_noun_	ἀστρονόμος_ἀστρολόγος_
ἡμέρα	adjective_noun_	ἥμερος_ἡμέρα_
Ἑρμῆς	verb_noun_	ἑρμάζω_Ἑρμῆς_
ἑτέρως	adjective_adverb_	ἕτερος_ἑτέρως_
λεγομένῳ	verb_verb_verb_	λέγω2_λέγω1_λέγω3_
σύνοδον	noun_noun_	σύνοδος1_σύνοδος2_
ἄληθες	verb_adverb_	ἀλήθω_ἀληθής_
Κυπάρισσον	noun_noun_	Κυπάρισσος_κυπάρισσος_
τελέσει	noun_verb_	τέλεσις_τελέω_
λαβῇ	noun_verb_	λαβή_λάπτω_
φύσει	noun_verb_verb_verb_	φύσις_φύω_φυσάω_φύζω_
ἐκείνοῦ	pronoun_verb_	ἐκεῖνος_κενόω_
παρίστησι	verb_verb_	παρίστημι_παριστάω_
σκότιος	noun_adjective_	σκότος_σκότιος_
ἴ̈δη	noun_verb_noun_	ἶδος_ἰδέω_ἴδη_
ἦγεν	verb_verb_	ἄγω_ἔσσομαι_
ἄρσε	verb_verb_	ἀραρίσκω_ἄρδω_
Αἰτωλοὶ	noun_adjective_	Αἰτωλοί_Αἰτωλός_
βῆ	adverb_verb_	βῆ_βαίνω_
Κλυτίοιο	noun_noun_	Κλύτιος_Κλυτίος_
ὑφ'	noun_preposition_	ὑφή_ὑπό_
ἀρχήν	noun_adverb_	ἀρχή_ἀρχήν_
λέγοντες	verb_verb_verb_	λέγω1_λέγω3_λέγω2_
Φρυγίαν	noun_noun_adjective_adjective_	Φρυγία_φρυγία_Φρύγιος_φρύγιος_
ἐπαΐξας	verb_verb_	ἐπαίσσω_ἐπᾴσσω_
πύργων	verb_noun_	πυργόω_πύργος_
κραδίης	noun_noun_	κραδίας_καρδία_
ἱστάμενος	verb_verb_	ἵστημι_ἱστάω_
δίεσαν	verb_verb_	δίεμαι_διίημι_
Ἑλέναι	noun_noun_	Ἑλένη_ἑλένη_
Ὅμηρος	noun_noun_	ὅμηρος_Ὅμηρος_
κοῦρον	noun_noun_	κοῦρος_κόρος2_
ἀλγέων	verb_noun_	ἀλγέω_ἄλγος_
περικεφαλαίας	adjective_noun_	περικεφάλαιος_περικεφαλαία_
τιθηνῶν	verb_verb_noun_adjective_	τιθηνέω_τιθηνέομαι_τιθήνη_τιθηνός_
δοκῶν	noun_verb_noun_verb_verb_	δοκή_δοκάζω_δοκώ_δοκέω_δοκόω_
δευτέρω	adjective_verb_	δεύτερος_δευτερόω_
ὁρμῶντος	verb_verb_	ὁρμάω_ὁρμάζω_
ὑπερέβησαν	verb_verb_	ὑπερβαίνω_ὑπερέπτω_
προσεδεῖτο	verb_verb_	προσδέομαι_προσδέω1_
μίσει	noun_verb_	μῖσος_μισέω_
ἀλλῶν	verb_verb_verb_verb_verb_	ἀνά-λούω_ἀνά-λάω1_ἀνά-λάζω_ἀνά-λάω2_ἀνά-λόω_
πλησίαι	adjective_adjective_	πλήσιος_πλησίος_
νομῆς	noun_verb_noun_	νομεύς_νομάζω_νομή_
τέτρωρον	adjective_noun_adjective_	τετράορος_τέτρωρον_τέτρωρος_
οὐλὰς	noun_noun_noun_	οὐλαί_οὐλάς_οὐλή_
πολέμιόν	adjective_verb_	πολέμιος_πολεμέω_
τοι	particle_pronoun_	τοι_σύ_
ἐλάτῃσι	noun_noun_	ἐλάτη_ἐλάτης_
ἀνδρεΐα	adjective_noun_	ἀνδρεῖος_ἀνδρεία_
λίνου	noun_noun_	λίνον_λίνος_
ἀκουστέον	adjective_adjective_	ἀκουστέον_ἀκουστέος_
πεδίῳ	noun_noun_	πεδίον_πέδιον_
μαντεύηται	verb_verb_	μαντεύομαι_μαντεύω_
ὅλοι	adjective_adjective_	ὅλοξ_ὅλος_
ἄκοντα	noun_adjective_	ἄκων_ἀέκων_
ἐξεδέξαντο	verb_verb_	ἐκδέχομαι_ἐκδείκνυμι_
τετεύχετον	verb_verb_	τυγχάνω_τεύχω_
παρεῖναι	verb_verb_	παρίημι_πάρειμι1_
δῆν	verb_verb_verb_	δεῖ_δέω2_δέω1_
ἐλέγομέν	verb_verb_verb_	λέγω3_λέγω2_λέγω1_
ἄρας	noun_noun_verb_	ἀρά_ἀρή_αἴρω_
Πυλίων	noun_adjective_	Πύλιοι_Πύλιος_
πρώτῃ	adjective_adjective_	πρῶτος_πρότερος_
πόλεσι	adjective_noun_	πολύς_πόλις_
Αἶαν	noun_noun_noun_	αἶα_Αἴας_Αἶα_
μάχης	verb_noun_	μαχάω_μάχη_
ἰὼν	verb_verb_	εἶμι_εἰμί_
ἄητον	adjective_verb_	ἄητος_ἄημι_
βίου	verb_noun_	βιόω_βίος_
υἱῶν	verb_noun_	υἱόω_υἱός_
Εὐρώπῃ	noun_noun_	Εὐρώπη_Εὐρώπης_
ἐπωνυμίαν	noun_adjective_	ἐπωνυμία_ἐπωνύμιος_
πλαγίων	noun_noun_verb_adjective_	πλάγος_πλάγιον_πλαγιόω_πλάγιος_
ἁλὶ	noun_noun_	ἅλς_ἁλίς_
μείων	adjective_verb_	μείων_μειόω_
συνδέσμουν	verb_verb_	σύν-δεσμέω_σύν-δεσμεύω_
ἀγρίου	verb_adjective_	ἀγριόω_ἄγριος_
χρεῖος	adjective_noun_	χρεῖος_χρέος_
ὄρει	noun_verb_	ὄρος_ὄρομαι_
σκορπίον	noun_noun_	σκορπίον_σκορπίος_
συνεργεῖ	verb_adjective_	συνεργέω_συνεργής_
θανάτου	verb_noun_	θανατόω_θάνατος_
λοιπά	noun_adjective_	λοιπάς_λοιπός_
ὀδύνας	noun_verb_	ὀδύνη_ὀδυνάω_
μόνους	verb_adjective_	μονόω_μόνος_
κυάνεον	adjective_verb_	κυάνεος_κυανέω_
ὁδός	noun_noun_	ὁδός2_ὁδός1_
βαρβάρων	verb_verb_adjective_	βαρβαρόω_βαρβαρόομαι_βάρβαρος_
κυβερνήτην	noun_verb_	κυβερνήτης_κυβερνάω_
ἀπειλουμένου	verb_verb_verb_	ἀπειλέω2_ἀπειλέω_ἀπειλέω1_
κυρίων	verb_noun_verb_noun_	κυρέω_κύριος_κυριόω_κῦρος_
ἀτυχθεὶς	verb_verb_	ἀτύζω_ἀτύζομαι_
ἀργύρω	noun_verb_	ἄργυρος_ἀργυρόω_
ποτ᾽	adjective_noun_preposition_particle_noun_	ποτός_ποτή_πρός_ποτέ_ποτόν_
Ὁμήρῳ	noun_noun_	ὅμηρος_Ὅμηρος_
πρώτοισι	adjective_adjective_	πρῶτος_πρότερος_
ἱερὴν	noun_adjective_	ἱερά_ἱερός_
συρίγγων	noun_verb_	σῦριγξ_συριγγόω_
ἁπαντᾷ	verb_noun_	ἀπαντάω_ἀπαντή_
βαφῆς	noun_noun_	βαφεύς_βαφή_
εἰκὼς	verb_verb_	εἰκός_ἔοικα_
ὃ	pronoun_article_	ὅς_ὁ_
μάσσεται	verb_verb_	μάσσω_μαίομαι_
φύλαξον	verb_verb_	φυλάσσω_φυλάζω_
βοηθεῖτε	verb_verb_	βοηθέω_βοάω_
παρειῶν	noun_noun_noun_	παρειά_παρείας_παρείης_
ὑποσχόμενος	verb_verb_	ὑπισχνέομαι_ὑπέχω_
αἰπόλῳ	noun_noun_	αἰπόλος_αἴπολος_
Γλαύκου	verb_noun_noun_noun_	γλαυκόω_Γλαῦκος_Γλαύκος_γλαῦκος_
ἀφανεῖς	verb_adjective_	ἀφανέω_ἀφανής_
ἐθεάσατο	verb_verb_	θεάομαι_θεάω_
δαῖέ	verb_verb_	δαίω2_δαίω1_
ὑποδεχθέντων	verb_verb_	ὑποδέχομαι_ὑποδείκνυμι_
Ἐπιστρόφου	noun_adjective_	Ἐπίστροφος_ἐπίστροφος_
οἰκεῖ	noun_verb_	οἰκεύς_οἰκέω_
ποτὲ	particle_adjective_	ποτέ_ποτός_
πονέεσθαι	verb_verb_	πονέομαι_πονέω_
ἴσου	adjective_verb_	ἴσος_ἰσόω_
μαντευομένους	verb_verb_	μαντεύομαι_μαντεύω_
Λοκρῶν	adjective_noun_	Λοκρός_Λοκροί_
ἠράσθη	verb_verb_	ἀράζω_ἔραμαι_
Σπάρτην	noun_noun_	σπάρτη_Σπάρτη_
θεοῦ	verb_noun_verb_	θεάω_θεός_θεάομαι_
θεράπων	noun_noun_	θέραψ_θεράπων_
ἄθροισιν	adjective_noun_	ἀθρόος_ἄθροισις_
ὅλον	adjective_adjective_	ὅλος_ὅλοξ_
ὑπέρμορα	adverb_adverb_	ὑπέρμορα_ὑπέρμορον_
ἰόντος	verb_verb_	εἰμί_εἶμι_
Ἴ̈λιον	adjective_adjective_noun_noun_	Ἴλι_Ἴλιοσλιος_Ἴλιος_Ἴλιον_
αἴσθησιν	verb_noun_	αἰσθάνομαι_αἴσθησις_
ἀντιγράφοις	adjective_verb_	ἀντίγραφος_ἀντιγράφω_
πληγῇσι	verb_noun_	πλήσσω_πληγή_
ἐνιπῇ	noun_verb_	ἐνιπή_ἐνίπτω_
ἄρη	verb_noun_noun_noun_noun_	ἀράω2_ἄρος_Ἄρης_ἀρή_ἀρά_
θ'	pronoun_particle_	σύ_τε_
σκιόωντα	verb_verb_	σκιάζω_σκιάω_
Ὕλην	noun_noun_verb_	ὕλη_Ὕλη_ὑλάω_
οἷ	pronoun_article_	ἕ_ὁ_
εὐνῇ	verb_verb_noun_	εὐνάω_εὐνάζω_εὐνή_
νείκους	noun_noun_	νεῖκος_νει_
ὀφείλομεν	verb_verb_	ὀφέλλω_ὀφείλω_
ὁμολογουμένως	adverb_verb_	ὁμολογουμένως_ὁμολογέω_
συνίστησιν	verb_verb_	συνίστημι_συνιστάω_
διονήσει	verb_verb_	διά-ὀνίνημι_διά-ὀνέομαι_
Πατρόκλου	noun_noun_	Πατρόκλον_Πάτροκλος_
σκοτίαν	noun_adjective_	σκοτία_σκότιος_
φήμῃ	noun_noun_	φῆμις_φήμη_
ἐδηδώς	verb_verb_	ἐσθίω_ἔδω_
βιβῶ	verb_verb_	βιβάζω_βιβάω_
ἰδίου	adjective_verb_	ἴδιος_ἰδίω_
ἠπίως	adjective_verb_	ἤπιος_ἠπιόω_
ἠέ	conjunction_conjunction_	ἤ1_ἠέ1_
σπουδῇ	noun_verb_	σπουδή_σπουδάζω_
Αἰγεῖ	noun_noun_	Αἰγίς_Αἰγεύς_
θαρσύνων	verb_adjective_	θαρσύνω_θάρσυνος_
ὁπλέων	verb_noun_	ὁπλέω_ὁπλή_
μ'	pronoun_pronoun_	ἐγώγε_ἐγώ_
Δίά	adjective_noun_noun_	δῖος_Ζεύς_Δίον_
δεξιῶν	adjective_verb_noun_	δεξιός_δεξιόομαι_δεξιά_
ἀρσενικὰ	adjective_noun_	ἀρσενικός_ἀρσενικόν_
ἐπιθέτω	noun_adjective_verb_noun_	ἐπίθετον_ἐπίθετος_ἐπιτίθημι_ἐπιθέτης_
θηρίου	verb_noun_	θηριόω_θηρίον_
Γανυμήδης	noun_noun_	Γανυμήδης_Γανυμήδη_
φωνῇ	noun_verb_	φωνή_φωνέω_
Σκῦρον	noun_noun_	σκῦρος_Σκῦρος_
βεβαίως	adjective_verb_	βέβαιος_βεβαιόω_
Αἰάντεσσιν	noun_verb_	Αἴας_αἰάζω_
Ἥβη	verb_noun_verb_noun_	ἅπτω_ἥβη_ἡβάω_Ἥβη_
πέπλους	noun_adjective_	πέπλος_πεπλος_
Σκύθου	noun_noun_	Σκύθης_σκύθος_
παρείκει	verb_verb_	παρίημι_παρείκω_
συγκοπῇ	verb_noun_	συγκόπτω_συγκοπή_
σῶς	adjective_adjective_	σός_σῶς_
δεκάτω	verb_adjective_verb_	δεκατόω_δέκατος_δεκάω_
εἰκότως	adverb_adverb_	ἐοικότως_εἰκότως_
εἴρηται	verb_verb_verb_verb_	ἔρομαι_εἴρω2_ἐρῶ_εἴρω_
τρίχα	adverb_noun_	τρίχα_θρίξ_
ξένος	noun_adjective_	ξένος1_ξένος2_
ἔσεισεν	verb_verb_	σείω_εἰσίζομαι_
ἁπλοῦ	verb_adjective_adjective_	ἁπλόω_ἁπλός_ἁπλόος_
θεᾶς	verb_noun_	θεάω_θεά_
Ἴ̈ασον	verb_noun_noun_	ἰάζω_Ἴασος_Ἰάσων_
τέο	pronoun_pronoun_	τις_σύ_
ἄκουσα	verb_adjective_	ἀκούω_ἀέκων_
σῇ	adjective_verb_	σός_σέω_
φιλῶν	verb_verb_noun_	φιλέω_φιλόω_φῖλος_
διασκευῆς	verb_noun_	διασκευάζω_διασκευή_
ποιουμένῳ	verb_verb_	ποιέω_ποιόω_
Ἄκτωρ	noun_noun_	ἄκτωρ_Ἄκτωρ_
Χάριν	adverb_noun_	χάρις_Χάρις_
ἐψηφίσατο	verb_verb_	ψηφίζω_ψηφίζομαι_
ἄξομαι	verb_verb_	ἄγω_ἄγνυμι_
πειρᾶν	verb_noun_noun_verb_	πειράω_πεῖρα_πειρά_πειράζω_
κεῖτ'	verb_verb_	κεῖμαι_κέω_
κόρης	noun_verb_noun_	κόρη_κορέω_κόρις_
ἤχου	verb_noun_	ἀχεύω_ἦχος_
νηπία	noun_adjective_	νηπιάα_νήπιος_
Ταύροις	noun_noun_	Ταῦρος_ταῦρος_
ἐλέγοντο	verb_verb_verb_	λέγω3_λέγω1_λέγω2_
σφῶ	adjective_verb_pronoun_	σφός_σφάζω_σφεῖς_
τὼς	adverb_article_	τώς_ὁ_
πυρὸς	noun_noun_	πῦρ_πυρός_
θεασάμενοι	verb_verb_	θεάομαι_θεάω_
ἁμαρτησόμεθα	verb_verb_	ἁμαρτάνω_ἁμαρτέω_
λεγομένοις	verb_verb_verb_	λέγω3_λέγω1_λέγω2_
ὑπεραῆϊ	verb_verb_	ὑπέρ-ἀάζω_ὑπέρ-ἀάω_
τροπῇ	verb_verb_noun_	τροπάομαι_τροπέω_τροπή_
ἰοὺς	noun_noun_	ἰός2_ἰός1_
εἰκότως	adverb_adverb_	εἰκότως_ἐοικότως_
ἐνδεεῖς	adjective_verb_	ἐνδεής_ἐνδέω2_
ὅλος	adjective_adjective_	ὅλοξ_ὅλος_
ἀκριβῆς	adjective_verb_	ἀκριβής_ἀκριβάζω_
λέγουσι	verb_verb_verb_	λέγω3_λέγω2_λέγω1_
ὧ	pronoun_verb_	ὅς_ἵημι_
ἐφορμῶσιν	verb_verb_	ἐφορμέω_ἐφορμάω_
ποτόν	noun_verb_adjective_	ποτόν_πρόσειμι1_ποτός_
Μόλου	noun_verb_	Μόλος_βλώσκω_
δύνηαι	verb_verb_	δύναμαι_δύω2_
πιστός	adjective_adjective_	πιστός1_πιστός2_
ἱρὰ	adjective_adjective_	ἱρός_ἱερός_
πειρασόμεθα	verb_verb_	πειράω_πειράζω_
ἀϋτῇ	noun_verb_	ἀυτή_ἀυτέω_
ἀνέμου	verb_noun_	ἀνεμόω_ἄνεμος_
ἔμβρωμα	noun_adjective_	ἔμβρωμα_ἔμβρωμος_
βασιλείαν	adjective_verb_noun_	βασίλειος_βασιλειάω_βασιλεία_
καρπῶν	verb_verb_noun_noun_	καρπέω_καρπόω_καρπός2_καρπός1_
Ἄδραστον	adjective_noun_	ἄδραστος_Ἄδραστος_
Ἀρήν	noun_noun_noun_	Ἀρή_ἀρά_ἀρή_
πατρί	noun_noun_	πατρίς_πατήρ_
Κίρκης	noun_noun_	κίρκη_Κίρκη_
κυνηγέτης	noun_verb_	κυνηγέτης_κυνηγετέω_
ἄνθει	verb_noun_	ἀνθέω_ἄνθος_
εἴσεται	verb_verb_	οἶδα_εἶμι_
Ζεῦ	noun_verb_	Ζεύς_ζέω_
Ἰ¨λίου	adjective_adjective_noun_noun_	Ἴλι_Ἴλιοσλιος_Ἴλιος_Ἴλιον_
ἠὲ	conjunction_conjunction_	ἠέ1_ἤ1_
λέγουσιν	verb_verb_verb_	λέγω1_λέγω3_λέγω2_
ποίη	adjective_verb_noun_	ποῖος_ποιέω_πόα_
μετρίων	verb_verb_adjective_	μετρέω_μετριάω_μέτριος_
ἐσχάτην	verb_adjective_verb_verb_	σχάζω_ἔσχατος_ἐσχατάω_σχάω_
ζῆν	verb_verb_	ζάω_ζέω_
Ὁμήρου	noun_noun_	Ὅμηρος_ὅμηρος_
ὠκέως	adjective_adverb_	ὠκύς_ὠκέως_
παλαιῶν	verb_adjective_	παλαιόω_παλαιός_
ἔδησεν	verb_verb_	δέω2_δέω1_
σόον	adjective_adjective_	σῶς_σόος_
τιμίων	verb_verb_adjective_verb_	τιμάω_τιμιόω_τίμιος_τιμέω_
Νάστης	noun_noun_	νάστης_Νάστης_
Θηβαϊκὸν	adjective_adjective_	Θηβαῖος_Θηβαικός_
κενῶς	adjective_verb_	κενός_κενόω_
ἣ	pronoun_article_	ὅς_ὁ_
πυκιναῖς	adjective_adjective_	πυκινός_πυκνός_
τρῶσιν	noun_verb_	τρῶσις_τρέω_
Πατρόκλοιο	noun_noun_	Πατρόκλον_Πάτροκλος_
ὁρμῶντες	verb_verb_	ὁρμάζω_ὁρμάω_
θελήσῃ	noun_verb_	θέλησις_ἐθέλω_
καλοῖο	adjective_verb_	καλός_καλέω_
οἶνον	noun_noun_	οἶνος_οἶνον_
λεχθέντα	verb_verb_	λέγω3_λέγω2_
ναίοιμεν	verb_verb_	ναίω1_ναίω2_
ἕκτην	adjective_noun_	ἕκτος_ἕκτη_
ἀλλῷ	verb_verb_verb_	ἀνά-λάζω_ἀνά-λάω2_ἀνά-λάω1_
ὑπέστρωσε	εἰσ-τιτρώσκ_verb_	ὑπό_ὑπό-στόρεννυμι_
δέοι	verb_verb_verb_	δέω2_δεῖ_δέω1_
ὑπερβίως	adjective_verb_	ὑπέρβιος_ὑπερβιόω_
Ἐχινάδες	noun_noun_	Ἐχῖναι_Ἐχινάδες_
Θηβαϊκῷ	adjective_adjective_	Θηβαικός_Θηβαῖος_
Νεφέλῃ	noun_noun_	Νεφέλη_νεφέλη_
χροιῇ	noun_verb_	χροιά_χροίζω_
ὄμβρῳ	noun_noun_	ὄμβρος_ὄμβρος_
μενέχαρμος	adjective_adjective_	μενεχάρμης_μενέχαρμος_
ὀλίγου	adjective_verb_	ὀλίγος_ὀλιγόω_
Νεστορέην	adjective_adjective_	Νεστόρεος_Νέστωρ_
σκηνῆς	verb_verb_noun_	σκηνάω_σκηνέω_σκηνή_
ἐρρίγω	verb_verb_verb_	ῥιγέω_ῥιγόω_ἐνριγόω_
κονία	verb_adjective_noun_	κονιάω_κόνιος_κονία_
κόπου	noun_verb_	κόπος_κοπόω_
βασιλέων	noun_noun_	βασίλη_βασιλεύς_
καθ'	adverb_adverb_preposition_	καθά_καθό_κατά_
οἶαι	noun_adjective_	οἴη_οἶος_
ἔκτυπε	adjective_verb_	ἔκτυπος_κτυπέω_
ἐγχωρίοις	adjective_verb_	ἐγχώριος_ἐγχωρέω_
πολεμοῦσιν	verb_verb_	πολεμέω_πολεμόω_
πυκνῶς	adjective_verb_	πυκνός_πυκνόω_
ἄνεω	adverb_adverb_	ἄνεω_ἀνεω_
Ἀνδρομάχῃ	adjective_noun_	ἀνδρομάχος_Ἀνδρομάχη_
λύχνου	noun_noun_	λύχνος_λύχνον_
ἐπιθέτοις	noun_adjective_	ἐπίθετον_ἐπίθετος_
ἐκδέξασθαι	verb_verb_	ἐκδέχομαι_ἐκδείκνυμι_
ἀρῶμαι	verb_verb_verb_verb_	ἀράζω_ἀράομαι_ἀρόω_ἀρέομαι_
ἀνδρεία	adjective_noun_	ἀνδρεῖος_ἀνδρεία_
Θαλῆν	verb_noun_verb_verb_	θάλλω_Θαλῆς_θαλέω_θηλέω_
βαρβάρους	verb_verb_adjective_	βαρβαρόω_βαρβαρόομαι_βάρβαρος_
Ὕπνος	noun_noun_	Ὕπνος_ὕπνος_
δεῖ	verb_verb_verb_	δέομαι_δέω2_δέω1_
λαιμοῦ	noun_verb_	λαιμός_λαιμάω_
χαριζόμεναι	verb_verb_	χαρίζω_χαρίζομαι_
πρέπων	noun_verb_	πρέπων_πρέπω_
πέλασαν	verb_verb_	πελάζω_πελάω_
Ἴ̈δης	noun_noun_verb_noun_	Ἴδη_ἴδη_ἰδέω_Ἴδης_
οὗ	adverb_pronoun_pronoun_verb_	οὗ_ἕ_ὅς_ἵημι_
ἧσο	verb_verb_	κάθημαι_ἧμαι_
Φθίας	noun_adjective_noun_adjective_	φθία_φθῖος_Φθία_Φθῖος_
καπνῶν	noun_noun_	καπνός_κάπνη_
ἐναντίον	adjective_adverb_	ἐναντίος_ἐναντίον_
Ἐρέβευς	noun_noun_	ἔρεβος_Ἔρεβος_
Ἀγάθων	verb_noun_	ἀγαθόω_Ἀγάθων_
Ταφίων	noun_adjective_adjective_noun_	Τάφιοι_Τάφιος_τάφιος_τάφος2_
λίς	noun_noun_	λίς2_λίς1_
Λοκρίδος	noun_noun_	Λοκρίς_Λοκρός_
τεοῖο	pronoun_adjective_	σύ_τεός_
Βρόμιον	adjective_verb_adjective_	Βρόμιος_βρομέω_βρόμιος_
Θοώτην	verb_noun_	θοόω_Θοώτης_
ἱερεῦσαι	verb_verb_	ἱερόω_ἱερεύω_
λέγῃσι	adjective_verb_verb_verb_	λέγος_λέγω2_λέγω3_λέγω1_
μερίμνης	verb_noun_	μεριμνάω_μέριμνα_
ἀνάσσεις	verb_verb_	ἀνάζω_ἀνάσσω_
κάλοῖς	noun_noun_	κάλως_κᾶλον_
λόγου	noun_verb_	λόγος_λογόω_
πρώτους	adjective_adjective_	πρότερος_πρῶτος_
φυλάσσηται	verb_verb_	φυλάζω_φυλάσσω_
Σώκοιο	noun_noun_	σῶκος_Σῶκος_
Πίσαν	noun_noun_	Πῖσα_πίσα_
σῶον	adjective_verb_	σῶς_σώω_
ἡμέραι	noun_adjective_	ἡμέρα_ἥμερος_
ὅλῳ	adjective_adjective_	ὅλοξ_ὅλος_
ἱστάμενα	verb_verb_	ἵστημι_ἱστάω_
Μουσῶν	verb_verb_noun_noun_	μουσόω_μουσόομαι_Μοῦσα_Μοῦσαι_
γραφῇ	noun_verb_noun_noun_	γραφής_γράφω_γραφή_γραφεύς_
ὀνήσει	verb_verb_verb_noun_verb_	ὀνέομαι_ὀνήνημι_ὀνίνημι_ὄνησις_ὀνὀνιμι_
ἔρεψα	verb_verb_verb_	ῥέπω_ἐρέπτοομαι_ἐρέφω_
μετρίως	verb_adjective_	μετριόω_μέτριος_
Ὀρέστην	noun_noun_	ὀρέστης_Ὀρέστης_
καταλιπῶν	verb_verb_	κατά-λιπάζω_κατά-λιπάω_
λέγωνται	verb_verb_verb_	λέγω1_λέγω2_λέγω3_
φωνῆς	noun_verb_	φωνή_φωνέω_
ἄρων	verb_noun_	ἀρόω_ἄρον_
Νύσαν	noun_noun_	νύσα_Νύση_
στρατηγοῦ	noun_verb_	στρατηγός_στρατηγέω_
ἀγωγὰ	adjective_noun_	ἀγωγός_ἀγωγή_
χρυσῷ	adjective_noun_	χρύσεος_χρυσός_
ἀσθενεῖ	adjective_verb_	ἀσθενής_ἀσθενέω_
πλέας	adjective_adjective_	πλέως_πλέος_
λούσῃ	verb_noun_verb_	λόω_λοῦσις_λούω_
πρόσφατον	verb_adjective_	πρόσφημι_πρόσφατος_
πιθοίατο	verb_verb_verb_	πείθω_πιθέω_πιθόω_
ὑπνῶσαι	verb_verb_	ὑπνόω_ὑπνάω_
ἀγκύλα	adjective_noun_	ἀγκύλος_ἀγκύλη_
τοὐπίσω	verb_verb_adverb_adjective_verb_	ὀπίζω_ἐφίζω_ὀπίσω_ἔπισος_πιπίσκω_
θηρευτῇσι	adjective_noun_	θηρευτός_θηρευτής_
πρωτόπλοος	adjective_adjective_	πρωτόπλοος_πρωτόπλους_
ἐπίστασθαι	verb_verb_	ἐφίστημι_ἐπίσταμαι_
ῥηθεῖσα	verb_verb_	ἐρῶ_ῥέομαι_
τί	irregular_pronoun_	τίς_τις_
κοινῇ	verb_adverb_adjective_	κοινόω_κοινῇ_κοινός_
ἰόντα	verb_verb_	εἰμί_εἶμι_
χαρίζεσθαι	verb_verb_	χαρίζω_χαρίζομαι_
Φόβος	noun_noun_	Φόβος_φόβος_
παρών	verb_noun_	πάρειμι1_παρών_
μελαίνας	adjective_noun_	μέλας_μέλαινα_
ξεινοδόκων	noun_noun_	ξεινοδόκος_ξενοδόκος_
σιτίων	verb_noun_verb_	σιτέομαι_σιτίον_σιτέω_
χειρόγραφον	adjective_noun_	χειρόγραφος_χειρόγραφον_
γονέων	verb_noun_noun_	γονάω_γονεύς_γονή_
Χάρις	noun_noun_	χάρις_Χάρις_
θείης	noun_adjective_verb_	θεία_θεῖος1_τίθημι_
λέγωμεν	verb_verb_verb_	λέγω2_λέγω1_λέγω3_
Χρύσην	noun_noun_	Χρύση_Χρύσης_
λέγεσθαι	verb_verb_verb_	λέγω1_λέγω2_λέγω3_
χεῖται	verb_verb_	χέω_χάω_
πότις	noun_noun_	πότης_πότις_
κακκεῖαι	verb_verb_	κακκάω_κατακαίω_
καταλείψῃ	verb_noun_verb_	καταλείβω_κατάλειψις_καταλιμπάνω_
ἔκλυον	verb_verb_	κλύω_ἐκλύω_
ἐλάταις	noun_noun_	ἐλάτη_ἐλάτης_
ξένων	verb_noun_adjective_	ξενόω_ξένος1_ξένος2_
ὤρα	noun_noun_	ὦρος_ὤρα_
Πηλείωνι	noun_noun_	Πηλείων_Πηλεύς_
Ἴ̈δηθεν	verb_adverb_	ἰδέω_Ἴδη_
ἔσσεται	verb_verb_	εἰμί_ἔσσομαι_
Διονύσω	noun_noun_	Διονύσος_Διόνυσος_
ἔφριξεν	verb_verb_	φρίσσω_φρίζω_
κόλῳ	adjective_noun_	κόλος_κόλον_
ἄξον	noun_noun_verb_	ἄξος_ἄξων_ἄγω_
ἀλώμενος	verb_verb_	ἀλάομαι_ἀλόω_
Πολεμωνίοις	noun_noun_	πολεμώνιον_Πολεμώνιον_
ἀφορῶν	verb_verb_	ἀφοράω_ἀφορέω_
ὁμωνυμίαν	adjective_noun_adjective_	ὁμωνύμιος_ὁμωνυμία_ὁμώνυμος_
περικεφαλαίαν	adjective_noun_	περικεφάλαιος_περικεφαλαία_
ἕπτ'	numeral_noun_	ἑπτά_ἑπτάς_
ἡνιοχῶν	noun_verb_	ἡνιόχη_ἡνιοχέω_
κυάνεαι	noun_adjective_verb_	Κυάνεαι_κυάνεος_κυανέω_
μικραί	adjective_adjective_	σμικρός_μικρός_
εὐθεία	noun_adjective_	εὐθεῖα_εὐθύς1_
ἐλαίας	verb_noun_	ἐλαιάω_ἐλαία_
δέδμηνται	verb_verb_	δέμω_δαμάζω_
Ἀθηναίῃ	adjective_noun_	Ἀθηναῖος_Ἀθήνη_
ὅμως	verb_conjunction_	ὁμόω_ὅμως_
ἀνέμους	noun_verb_	ἄνεμος_ἀνεμόω_
ἐνώπια	noun_adjective_	ἐνώπια_ἐνώπιος_
καρποὺς	noun_noun_	καρπός1_καρπός2_
Ἄργει	noun_verb_	Ἄργος_ἀργέω_
μαλακοῖς	verb_adjective_	μαλακόω_μαλακός_
τραπῆναι	verb_verb_	τέρπω_τρέπω_
ἰσχυρῶς	adjective_verb_	ἰσχυρός_ἰσχυρόω_
ἐπίσκοπος	adjective_noun_	ἐπίσκοπος2_ἐπίσκοπος1_
σίγιον	verb_noun_	σιγάω_σίγιον_
πάσαις	adjective_verb_	πᾶς_πάσσω_
τάχει	adjective_noun_	ταχύς_τάχος_
ὁρμᾶν	verb_verb_noun_	ὁρμάζω_ὁρμάω_ὁρμή_
καυλῶ	noun_verb_	καυλός_καυλέω_
κυνόσουρα	noun_adjective_	κυνόσουρα_κυνόσουρος_
παρῆκε	verb_verb_	παρήκω_παρίημι_
ὁδὸν	noun_noun_	ὁδός1_ὁδός2_
κερτομίοισι	adjective_verb_	κερτόμιος_κερτομέω_
λευκῷ	adjective_noun_	λευκός_λευκόν_
ἐπιπλήξει	verb_noun_	ἐπιπλήσσω_ἐπίπληξις_
Θρᾳκίου	adjective_adjective_noun_	Θρᾷξ_Θρᾴκιος_Θρᾳκίας_
στερεοῖς	verb_adjective_	στερεόω_στερεός_
ἀγωγά	adjective_noun_	ἀγωγός_ἀγωγή_
Ἀθήνη	noun_noun_	Ἀθῆναι_Ἀθήνευς_
μάχη	verb_noun_	μαχάω_μάχη_
δώσουσι	verb_noun_	δίδωμι_δώσων_
ψιλοὶ	adjective_verb_	ψιλός_ψιλόω_
ἕλκη	verb_noun_	ἑλκέω_ἕλκος_
ἠνορέῃ	noun_noun_	ἠνορέη_ἠνορέα_
κεινῇσι	adjective_adjective_	κενός_κεινός_
καλῶν	noun_verb_noun_adjective_	κήλη_καλέω_κάλη_καλός_
πυκινόν	adjective_adjective_	πυκνός_πυκινός_
πολεμουμένων	verb_verb_	πολεμέω_πολεμόω_
σκέπην	verb_verb_verb_noun_noun_	σκεπάω_σκέπτομαι_σκέπω_σκέπος_σκέπη_
ἀγάσσατο	verb_verb_	ἄγαμαι_ἀγάζω_
Λεκτόν	noun_adjective_	Λεκτός_λεκτός_
ἰ̈κέλως	verb_adjective_	ἰκελόω_ἴκελος_
ψιλῶ	verb_adjective_	ψιλόω_ψιλός_
ἡγεῖτο	verb_verb_	ἡγέομαι_ἁγέομαι_
Λεσβία	adjective_adjective_	λέσβιος_Λέσβιος_
φυλάσσειν	verb_verb_	φυλάζω_φυλάσσω_
ἀκούσιον	adjective_adjective_	ἀεκούσιος_ἀκούσιος_
παρ᾽	preposition_adjective_	παρά_πηρός_
ἀναγνώσει	noun_verb_	ἀνάγνωσις_ἀναγιγνώσκω_
φύκιον	noun_noun_	φυκίον_φύκιον_
οὐδέ	particle_noun_noun_	οὐδέ_οὐδός1_οὐδός2_
ὑπήκοοί	adjective_adjective_	ὑπήκοος_ὑπήκους_
κωφῷ	verb_adjective_	κωφάω_κωφός_
φλῶ	verb_verb_	φλέω_φλάω_
στρατοῦ	verb_verb_noun_	στρατάω%2_στρατόω_στρατός_
διήγειρεν	verb_verb_	διά-ἀγείρω_διά-ἐγείρω_
Μαίων	noun_adjective_noun_	Μαίων_Μάιος_μαῖον_
ὄψει	noun_noun_verb_	ὄψις_ὄψος_ὁράω_
βουκόλους	noun_noun_	βουκόλος_βούκολος_
λέπω	verb_verb_	λεπόω_λέπω_
ἀήτη	noun_noun_	ἀήτη_ἀήτης_
Χάριτος	adjective_noun_noun_	χάριτος_χάρις_Χάρις_
γύαλον	noun_noun_	γύαλον_γύαλος_
Ἕκτορι	noun_noun_	ἕκτωρ_Ἕκτωρ_
ὀρέων	noun_noun_	ὄρος_ὀρεύς_
μεσημβρίαν	verb_adjective_noun_	μεσημβριάω_μεσήμβριος_μεσημβρία_
νεών	noun_noun_noun_noun_	νεών_ναῦς_ναός_νεώς_
τοξίας	noun_noun_	τοξίας_τοξία_
Ὁμήρω	noun_noun_	ὅμηρος_Ὅμηρος_
ἀξίων	verb_verb_verb_verb_adjective_	ἄγω_ἀξιάω_ἀξιόω_ἄγνυμι_ἄξιος_
σαώσωμεν	verb_verb_	σαόω_σώζω_
ᾗ	pronoun_adverb_verb_	ὅς_ᾗ_ἵημι_
Ἴδηθεν	verb_adverb_	ἰδέω_Ἴδη_
λεῖον	noun_adjective_	λείων_λεῖος_
ἔνδοθεν	verb_adverb_	ἐνδίδωμι_ἔνδοθεν_
Λυδίας	noun_adjective_noun_	Λυδία_Λύδιος_Λυδίας_
δίνης	verb_noun_verb_	δινεύω_δίνη_δινέω_
ὁμῶς	adverb_verb_	ὁμῶς_ὁμόω_
συμφράσσομαι	verb_verb_verb_	συμφράζω_συμφράζομαι_συμφράσσω_
δήσαντες	verb_verb_	δέω1_δέω2_
κοῖλος	adjective_adjective_	κόιλος_κοῖλος_
ἤρη	noun_verb_	ἤρα_ἐρέω_
πὸλει	verb_noun_	πολέω_πόλις_
μαντεύεται	verb_verb_	μαντεύω_μαντεύομαι_
μεταβάσεις	verb_noun_	μεταβαίνω_μετάβασις_
Μακεδονικὸς	adjective_adjective_	Μακεδονικός_Μακεδ́νιος_
ἔμπλητο	verb_verb_	ἐμπελάζω_ἐμπίπλημι_
ἁπαντήσει	noun_verb_	ἀπάντησις_ἀπαντάω_
οὐλάς	noun_noun_noun_	οὐλαί_οὐλή_οὐλάς_
χειμάρρων	adjective_adjective_	χειμάρρους_χείμαρρος_
τιμῶσαι	verb_verb_	τιμάω_τιμόω_
χάσμα	noun_verb_noun_	χάσμα_χασμάω_χάσμη_
πόλει	noun_verb_	πόλις_πολέω_
ὀργῆς	noun_verb_verb_	ὀργή_ὀργάω_ὀργάζω_
Κρήτῃ	noun_noun_	κρήτη_Κρήτη_
μουσικῆς	noun_adjective_	μουσική_μουσικός_
ἐλίσσεθ'	verb_verb_verb_	ἑλίσσω_λίσσομαι_ἐλίσσω_
ἐφήσω	verb_verb_verb_verb_	φημί_ἐφήδομαι_ἐφίημι_ἐφέζομαι_
καθέζεσθαι	verb_verb_	κατά-καθέζομαι_κατά-ἕζομαι_
πάλαι	verb_noun_noun_adverb_	πάλλω_πάλα_πάλη_πάλαι_
ἱστᾶσιν	verb_verb_	ἵστημι_ἱστάω_
μόρον	noun_noun_	μόρον_μόρος_
μεταβολῆς	noun_noun_	μεταβολή_μεταβολεύς_
νείκεα	noun_noun_	νεῖκος_νει_
θέρμης	noun_noun_	θέρμα_θέρμη_
λέγοντας	verb_verb_verb_	λέγω1_λέγω3_λέγω2_
Ἄτη	noun_noun_	Ἄτη_ἄτη_
ἰ̈ὼν	verb_verb_	εἰμί_εἶμι_
ἄγε	adverb_verb_	ἄγε_ἄγω_
τελευτᾶν	verb_noun_	τελευτάω_τελευτή_
Δαναούς	noun_noun_	Δαναός_Δαναοί_
ἀπείλησαν	verb_verb_verb_	ἀπειλέω_ἀπειλέω2_ἀπειλέω1_
πομπῇ	noun_noun_	πομπεύς_πομπή_
φιλίας	noun_adjective_	φιλία_φίλιος_
φύσεις	verb_noun_verb_	φύζω_φύσις_φύω_
Λάαν	verb_verb_noun_	λάω2_λάω1_Λάας_
ὁμοία	adjective_adjective_	ὅμοιος_ὁμοῖος_
ἡδονὴ	noun_noun_	ἡδονή_ἡδονά_
δώσουσ'	verb_noun_	δίδωμι_δώσων_
πεφύκει	verb_verb_	φύω_φύζω_
χεῖ	verb_verb_	χάω_χέω_
συμφωνήσει	noun_verb_	συμφώνησις_συμφωνέω_
μεθίστησιν	verb_verb_	μεθίστημι_μεθιστάω_
Δία	adjective_noun_noun_	δῖος_Ζεύς_Δίον_
φίλων	noun_adjective_verb_	φίλων_φίλος_φιλόω_
θῦσαι	verb_verb_	θύω2_θύω1_
ποθ'	adverb_adjective_noun_noun_noun_particle_preposition_	ποθι_ποτός_ποτή_ποτόν_ποθή_ποτέ_πρός_
ἐπεισόδιον	noun_adjective_	ἐπεισόδιον_ἐπεισόδιος_
ἄειρε	adjective_verb_	ἄειρος_ἀείρω_
τιμᾶς	verb_noun_	τιμάω_τιμή_
κήλεον	adjective_verb_	κήλεος_κηλέω_
ἄρχον	noun_verb_	ἄρχων_ἄρχω_
βία	verb_noun_	βιάω_βία_
Βοιωτίης	noun_adjective_	Βοιωτία_Βοιώτιος_
ἄκρῳ	noun_adjective_	ἄκρον_ἄκρος_
νῶϊ	verb_pronoun_noun_	νάω_ἐγώ_νόος_
ἐμέ	adjective_pronoun_	ἐμός_ἐγώ_
ποτέ	particle_adjective_	ποτέ_ποτός_
δεσποτῶν	noun_verb_	δεσπότης_δεσποτέω_
δίδου	verb_verb_	δίδημι_δίδωμι_
προσταχθὲν	verb_verb_	προσστάζω_προστάσσω_
ἀναδεξάμενον	verb_verb_	ἀναδείκνυμι_ἀναδέχομαι_
φυλαχθῇ	verb_verb_	φυλάσσω_φυλάζω_
Αὐγέας	adjective_noun_	αὐγής_Αὐγέας_
ῥυσάσθην	verb_verb_	ῥυσάω_ῥύομαι_
Κάλχας	noun_noun_	Κάλχας_κάλχη_
γαίων	adjective_verb_verb_	γάιος_γαίω_γαιόω_
χρόα	noun_noun_	χρώς_χροιά_
λεπτόν	adjective_noun_	λεπτός_λεπτόν_
θεῷ	verb_noun_	θεάω_θεός_
Ζῆνα	noun_adjective_	Ζεύς_ζῆνος_
Μύνης	noun_noun_	μύνη_Μύνης_
τάφου	verb_noun_	τέθηπα_τάφος1_
πλεῖαι	adjective_verb_	πλέως_πλέω_
προφάσει	noun_verb_	πρόφασις_προφάω_
πόλεις	noun_adjective_noun_verb_	πόλις_πολύς_πόόλις_πολέω_
λέξατο	verb_verb_verb_	λέγω1_λέγω3_λέγω2_
ἴδης	noun_verb_	ἴδη_ἰδέω_
ψυχῆς	verb_noun_	ψυχάζω_ψυχή_
πανόπτου	noun_adjective_	πανόπτης_πάνοπτος_
Τὰ	irregular_article_	τίς_ὁ_
κρημνοῦ	noun_verb_	κρημνός_κρημνάω_
κερδῶ	noun_verb_	κερδώ_κερδαίνω_
ὀργῇ	noun_verb_verb_	ὀργή_ὀργάω_ὀργάζω_
Φάνης	verb_verb_noun_noun_	φανάω_φαίνω_φάνης_Φάνης_
Νεφέλη	noun_noun_	νεφέλη_Νεφέλη_
πλησίων	adjective_adjective_verb_	πλησίος_πλήσιος_πίμπλημι_
ἄκραι	noun_adjective_	ἄκρα_ἄκρος_
πολέμων	verb_noun_	πολεμόω_πόλεμος_
ὡρμῆσθαι	verb_verb_	ὁρμέω_ὁρμάω_
ὑπτίου	adjective_verb_	ὕπτιος_ὑπτιόω_
Ἔφιππος	noun_adjective_	Ἔφιππος_ἔφιππος_
Θυέστου	noun_noun_noun_	θυέστης_θύεστον_Θυέστης_
κἀγὼ	pronoun_noun_	ἐγώ_ἀγός_
ναυπηγεῖ	adjective_verb_	ναυπηγής_ναυπηγέω_
αἵμ'	noun_noun_	αἱμάς_αἱμός_
Διονύσου	noun_noun_	Διόνυσος_Διονύσος_
Kαρῶν	noun_verb_noun_noun_	καρώ_καρόω_κάρ_κάρα_
βέῃ	verb_verb_	βαίνω_βέομαι_
μέση	noun_adjective_noun_	μέση_μέσος_μέσης_
δότω	noun_verb_	δότης_δίδωμι_
κόρυθος	noun_noun_	κόρυθος_κόρυς_
χρυσίου	adjective_noun_	χρύσεος_χρυσίον_
Γοργόνα	noun_noun_	Γοργών_Γοργόνη_
ἰοῦσα	verb_verb_verb_	ἰόω_εἰμί_εἶμι_
πέρατα	noun_adjective_	πέρας_πέρατος_
ὅτι	conjunction_adverb_pronoun_	ὅτι2_ὅτι1_ὅστις_
ἀπολλύμενον	verb_verb_	ἀπολύω_ἀπόλλυμι_
ἴσους	verb_adjective_	ἰσόω_ἴσος_
ἀπορούμενον	verb_verb_	ἀπορέω_ἀφοράω_
τιμῆς	noun_verb_verb_	τιμή_τιμάω_τιμέω_
παραιβάτην	noun_verb_	παραβάτης_παραβαίνω_
πρέσβεις	noun_noun_	πρέσσβυς_πρέσβις_
ναίοιτε	verb_verb_	ναίω1_ναίω2_
πηγῇ	adjective_verb_noun_verb_	πηγός_πήσσω_πηγή_πηγάζω_
μαντεύσασθαι	verb_verb_	μαντεύω_μαντεύομαι_
ὀμμάτων	noun_verb_	ὄμμα_ὀμματόω_
οἵπερ	pronoun_article_pronoun_	ὅς_ὁ_ἕ_
ἐπεπλήρωτο	verb_verb_	πληρόω_ἐπιπληρόω_
λέξασθαι	verb_verb_verb_	λέγω2_λέγω1_λέγω3_
μύας	verb_noun_	μυάω_μῦς_
σχήσεσθ'	verb_verb_	σχάω_ἔχω_
γειτνιῶντα	verb_verb_	γειτνιάω_γειτνιάζω_
τραυματία	noun_noun_	τραυματίας_τραυματίης_
ποίησ'	verb_noun_	ποιέω_ποίησις_
σάω	adjective_verb_verb_	σῶς_σαόω_σώζω_
μελάνει	verb_verb_	μελανέω_μελάνω_
ἄρθρων	verb_noun_	ἀρθρόω_ἄρθρον_
Φθίην	noun_adjective_adjective_noun_verb_	Φθία_Φθῖος_φθῖος_φθία_φθίω_
ναυστάθμῳ	noun_noun_	ναύσταθμος_ναύσταθμον_
ὑπάρχων	noun_verb_	ὕπαρχος_ὑπάρχω_
εἴπω	noun_verb_	εἶπος_εἶπον_
κατανεύσῃ	verb_verb_noun_	κατανέω_κατανεύω_κατάνευσις_
φάνεσκεν	verb_verb_	φανάω_φαίνω_
Ἀστακοῦ	noun_noun_	ἀστακός_Ἀστακός_
λέγεται	verb_verb_verb_	λέγω3_λέγω2_λέγω1_
μῆλον	noun_noun_	μῆλον1_μῆλον2_
ἕλικας	noun_noun_	ἕλιξ2_ἕλιξ1_
πῶς	particle_adverb_noun_	πως_πῶς2_πῶς_
εἶ	verb_conjunction_verb_	εἰμί_εἰ_εἶμι_
χωόμενος	verb_verb_verb_	χάω_χάζομαι_χώομαι_
συγκλασθέντος	verb_verb_	συγκλάω_συγκλάζω_
ἀρητόν	adjective_adjective_	ἀρατός_ἀρητός_
στείνει	verb_noun_	στείνω_στεῖνος_
θύοντες	verb_verb_	θύω1_θύω2_
στρατιὰν	noun_noun_	στρατιά_στρατία_
φρατρίας	noun_adjective_	φράτρα_φράτριος_
πόλεων	noun_adjective_noun_	πόλις_πολύς_πόόλις_
ἀγαπῶντος	verb_verb_	ἀγαπάω_ἀγαπάζω_
προπεριέσπασαν	verb_περ_	πρό-περισπάω_πρό_
οὐδέ	noun_noun_particle_	οὐδός1_οὐδός2_οὐδέ_
βῶ	verb_verb_	βάζω_βαίνω_
δεξαμένοις	verb_verb_	δείκνυμι_δέχομαι_
οὖρον	noun_noun_noun_noun_noun_noun_noun_	οὖρος2_οὖρον1_οὐρός_οὖροσὖρος4_οὖρον2_οὐρόσς_οὖρος1_
Λυκίων	noun_adjective_	λύκιον_Λύκιος_
ὁμοῦ	adverb_verb_adjective_	ὁμοῦ_ὁμόω_ὁμός_
ἦ	verb_adverb_verb_	ἠμί_ἦ_εἰμί_
ἀγκῶν	noun_noun_	ἀγκή_ἄγκος_
ἄπιστα	verb_adjective_	ἀφεστήξω_ἄπιστος_
στενοῖς	adjective_verb_	στενός_στενόω_
κεῖθ'	adverb_verb_verb_	ἐκεῖθι_κέω_κεῖμαι_
κυδάνει	verb_verb_	κυδάνω_κυδαίνω_
κούρους	noun_noun_	κόρος2_κοῦρος_
Κύπρια	adjective_noun_noun_adjective_	κύπριος_Κύπρια_κύπριον_Κύπριος_
ἀυτῶν	noun_verb_	ἀυτή_ἀυτέω_
ποιῶ	adjective_verb_verb_	ποιός_ποιέω_ποιόω_
κούρω	noun_noun_	κοῦρος_κόρος2_
περιπολῶν	verb_verb_	περιπολέω_περιπολάζω_
ἄθλιον	adjective_verb_	ἄθλιος_ἀθλέω_
ἐδέξαντο	verb_verb_	δείκνυμι_δέχομαι_
ἀναιροῦντα	verb_verb_	ἀναιρέω_ἀνιερόω_
Χρύσης	noun_noun_	Χρύση_Χρύσης_
δικαία	noun_adjective_	δικαία_δίκαιος_
ἥλου	verb_noun_	ἅλλομαι_ἧλος_
Ἀττικὴ	noun_adjective_	Ἀττική_Ἀττικός_
ἀκοῦσαι	verb_verb_	ἀκέω_ἀκούω_
κόρσης	noun_noun_	κόρση_κόρσης_
Ἀμφιπολίτης	noun_adjective_	Ἀμφιπολίτης_Ἀμφιπόλιτος_
βυθοῦ	noun_verb_	βυθός_βυθάω_
ἕθεν	verb_pronoun_	ἵημι_ἕ_
ἀργόν	adjective_adjective_	ἀργός2_ἀργός1_
μέλαν	adjective_noun_	μέλας_μέλη_
σχολῆς	noun_verb_	σχολή_σχολάζω_
φόνου	noun_verb_	φόνος_φονόω_
θορὸν	noun_verb_	θορός_θρῴσκω_
μαρτύριον	noun_verb_	μαρτύριον_μαρτυρέω_
ἤρων	noun_verb_noun_verb_noun_verb_	ἦρος_ἐράω1_ἤρα_ἀρόω_ἔαρ_ἀείω2_
σύνθετόν	adjective_verb_	σύνθετος_συντίθημι_
Λοκροὺς	adjective_noun_	Λοκρός_Λοκροί_
δεὶνῶν	noun_verb_pronoun_	δεῖνος_δεινόω_δεῖνα_
μικροῦ	adjective_adjective_	σμικρός_μικρός_
σάκος	noun_noun_	σάκκος_σάκος_
εἴδει	noun_verb_	εἶδος_εἴδομαι_
ξένον	adjective_noun_	ξένος2_ξένος1_
δαμναμένους	verb_verb_	δαμνάω_δάμνημι_
ἀναγκαία	noun_adjective_noun_	ἀναγκαίη_ἀναγκαῖον_ἀνάγκη_
οἶμαι	verb_noun_	οἴομαι_οἴμη_
ἄριστον	adjective_noun_	ἄριστος_ἄριστον_
ἐδέξατο	verb_verb_	δείκνυμι_δέχομαι_
Κρίσου	noun_noun_	Κρίσος_Κρῖσος_
πρόσθ'	noun_noun_adverb_	προστάς_πρόσθη_πρόσθεν_
ὑπόσχοιτο	verb_verb_	ὑπισχνέομαι_ὑπέχω_
κινήσῃ	noun_verb_	κίνησις_κινέω_
λέγοντα	verb_verb_verb_	λέγω2_λέγω3_λέγω1_
βουκόλιον	noun_verb_	βουκόλιον_βουκολέω_
ὑγιῆς	verb_adjective_	ὑγιάζω_ὑγιής_
Τροίζηνος	noun_noun_	Τροίζηνος_Τροίζην_
μεθέξεις	verb_noun_	μετέχω_μέθεξις_
τριχῶς	verb_adverb_	τριχόω_τριχῶς_
κατάρα	noun_noun_	κατάρης_κατάρα_
Ὑριέως	noun_noun_	Ὑριεύς_Ὑρίευς_
μέρη	noun_noun_	μέρα_μέρος_
νάω	verb_verb_	ναόω_νάω_
τίσιν	pronoun_noun_irregular_	τις_τίσις_τίς_
Καλλίμαχον	adjective_noun_	καλλίμαχος_Καλλίμαχος_
καρδίη	noun_verb_	καρδία_καρδιάω_
δέξεται	verb_verb_	δείκνυμι_δέχομαι_
ἡμερῶν	noun_verb_	ἡμέρα_ἡμερόω_
σκοπῶν	verb_verb_noun_noun_	σκοπάω_σκοπέω_σκοπός_σκοπή_
ὁδούς	noun_noun_	ὁδός1_ὁδός2_
Ἀδραμύττιον	noun_noun_	Ἀδραμύττειον_Ἀδραμύττιον_
ὅλου	adjective_adjective_	ὅλοξ_ὅλος_
ὑψοῦ	adverb_verb_	ὑψοῦ_ὑψόω_
ἀργῷ	adjective_adjective_	ἀργός1_ἀργός2_
αὔξει	verb_noun_	αὐξάνω_αὖξις_
νεῦμαι	verb_verb_verb_	νέω3_νέω_νέομαι_
ἁπαρχῆς	noun_verb_noun_	ἐπαρχή_ἐπαρχέω_ἀπαρχή_
ῥιζῶν	verb_noun_	ῥιζόω_ῥίζα_
ἀλοία	verb_verb_	ἀλοάω_ἀλοιάω_
λέγη	adjective_verb_	λέγος_λέγω1_
μαχέσκετο	verb_verb_verb_verb_	μαχάω_συμμαχέω_μάχομαι_μαχέ_
λείριον	noun_adjective_	λείριον_λείριος_
Πύλιοι	noun_adjective_	Πύλιοι_Πύλιος_
ἀναβῆναι	verb_verb_	ἀναβαίνω_ἀνάπτω_
ἀυτῇ	verb_noun_	ἀυτέω_ἀυτή_
νῶ	verb_verb_verb_verb_verb_	νέω3_νέω_νέω2_νέω1_νάω_
Λιταί	noun_adjective_	λιτή_λιτός_
ἄξαντο	verb_verb_	ἄγνυμι_ἄγω_
φειδώμεθα	verb_verb_	φειδέομαι_φείδομαι_
εὐθεῖα	adjective_noun_	εὐθύς1_εὐθεῖα_
Θρακῶν	noun_noun_	Θρᾷξ_Θράκη_
ἁλίοιο	adjective_noun_adjective_verb_	ἅλιος1_ἥλιος_ἅλιος2_ἅλλομαι_
λεγόμενος	verb_verb_verb_	λέγω1_λέγω3_λέγω2_
ἔξοδος	adjective_noun_	ἔξοδος2_ἔξοδος1_
ἀγαπᾶσθαι	verb_verb_	ἀγαπάω_ἀγαπάζω_
Διομήδη	noun_noun_	Διομήδης_Διομήδη_
νευρὴν	noun_noun_	νευρή_νευρά_
σκοπεῖν	verb_verb_	σκοπάω_σκοπέω_
Ἑκάτη	noun_noun_	ἑκάτη_Ἑκάτη_
βοόωσιν	verb_verb_	βοόω_βοάω_
ἐθεάσαντο	verb_verb_	θεάομαι_θεάω_
τύχῃ	verb_noun_	τυγχάνω_τύχη_
ποιήσῃ	verb_noun_	ποιέω_ποίησις_
ἥρῳ	noun_noun_	ἥρως_ἥρως_
κυριεύσας	verb_verb_verb_	κυριόω_κυριεύω_κυρίζω_
ᾠήθη	verb_verb_	οἰάω_οἴομαι_
ἱππηλάτης	verb_noun_	ἱππηλατέω_ἱππηλάτης_
κύριον	verb_noun_	κυρέω_κύριος_
Διομήδη	noun_noun_	Διομήδη_Διομήδης_
ἁπολοῦν	verb_verb_	ἀπολούω_ἀπόλλυμι_
ἄπεισιν	verb_verb_	ἄπειμι2_ἄπειμι1_
διδάξει	noun_verb_	δίδαξις_διδάσκω_
ἠῶ	verb_noun_	ἀάω_ἠώς_
τρίτην	adjective_verb_	τρίτος_τριτάω_
μοίρας	noun_verb_	μοῖρα_μοιράω_
Εὐριπίδης	noun_noun_	Εὐριπίδης_εὐριπίδης_
ποτέρου	verb_adjective_	προσερέσθαι_πότερος_
δεξιοῦ	adjective_verb_	δεξιός_δεξιόομαι_
μηνιῶν	verb_verb_	μηνιάω_μηνίζω_
ἱκανῶς	adjective_verb_	ἱκανός_ἱκανόω_
βεβολήατο	verb_verb_verb_	βεβόλημαι_ἀντιβολέω_βολέω_
Ἴλιος	noun_adjective_adjective_	Ἴλιος_Ἴλιοσλιος_Ἴλι_
ἐπέταξεν	verb_verb_	ἐπιτάσσω_πετάζω_
κόρον	noun_noun_noun_	κόρος3_κόρος2_κόρος1_
φίλαι	verb_adjective_	φιλέω_φίλος_
Ἠελίοιο	noun_noun_noun_	ἠέλιος_Ἥλιος_ἥλιος_
Κάειρα	noun_noun_	Κάρ_Κάειρα_
Χλούνῃ	noun_noun_	χλοῦνις_χλούνης_
φιλονικεῖν	verb_verb_	φιλονικέω_φιλονεικέω_
δίνη	noun_verb_	δίνη_δινέω_
ἔχθραν	noun_noun_	ἔχθρα_ἔχθρη_
δεινῷ	verb_adjective_	δεινάζω_δεινός_
ἔγχεις	verb_verb_	ἐγχύνω_ἐγχέω_
κορυφῶν	noun_verb_	κορυφή_κορυφόω_
ποίμνια	noun_adjective_	ποίμνιον_ποίμνιος_
Σινωπικὴ	adjective_noun_	Σινωπικός_Σινωπική_
βιβῶν	verb_verb_	βιβάω_βιβάζω_
λέγουσα	verb_verb_verb_	λέγω3_λέγω2_λέγω1_
ἀναπεπταμένου	adjective_verb_	ἀναπεπταμένος_ἀναπετάννυμι_
χρῶνται	verb_verb_verb_verb_	χραύω_χράομαι_χράω1_χράω2_
ἄκρας	noun_adjective_	ἄκρα_ἄκρος_
Σύροις	verb_noun_noun_noun_noun_	σύρω_σύρον_Σῦρος_Σύρος_σύρος_
ἀξίαν	verb_noun_adjective_	ἀξιάω_ἀξία_ἄξιος_
Τροίην	noun_verb_	Τροία_τρέω_
μῆνας	verb_noun_	μαίνομαι_μείς_
Δῶρ᾽	noun_noun_noun_noun_	Δῶρις_δῶρον_Δῶρα_Δῶρος_
θέας	verb_noun_	θεάω_θέα_
βουλήσει	verb_noun_	βούλομαι_βούλησις_
θείοιο	noun_adjective_verb_verb_	θεῖος2_θεῖος1_θεάω_θεάομαι_
μέλαινα	adjective_noun_	μέλας_μέλαινα_
εὐτραφεῖς	adjective_verb_	εὐτραφής_εὐτραφέω_
τάχιστα	adjective_adjective_	τάχιστος_ταχύς_
πειρᾶ	verb_verb_	πειράω_πειράζω_
δήσας	verb_verb_	δέω2_δέω1_
πέλει	verb_verb_	πέλω_πελάω_
κραδίη	noun_noun_	κραδίας_καρδία_
πάσα	adjective_verb_	πᾶς_πάσσω_
ἦν	verb_verb_	εἰμί_ἠμί_
μόνω	adjective_verb_	μόνος_μονόω_
κομῆται	noun_verb_verb_	κομήτης_κομάω_κομέω_
κείνους	verb_adjective_pronoun_	κενόω_κεῖνος_ἐκεῖνος_
βίω	verb_verb_noun_	βαίνω_βιόω_βίος_
πάγῳ	noun_noun_	πᾶγος_πάγος_
βασιλείας	verb_noun_noun_adjective_	βασιλειάω_βασίλεια_βασιλεία_βασίλειος_
συνίστησι	verb_verb_	συνιστάω_συνίστημι_
μῆνα	verb_noun_	μαίνομαι_μείς_
Σκαιὰς	adjective_adjective_noun_noun_	σκαιός_Σκαιός_Σκαιαί_Σκαίη_
διάπυροι	adjective_adjective_	διαπυρος_διάπυρος_
πάρεσαν	verb_verb_verb_	παρίημι_πάρειμι1_παρέζομαι_
Σκαιῶν	adjective_adjective_noun_noun_	σκαιός_Σκαιός_Σκαίη_Σκαιαί_
παίσας	verb_verb_adjective_	παίω1_παίζω_πᾶς_
χραίσμη	noun_verb_	χραίσμη_χραισμέω_
ἀπαιωροῦσιν	verb_verb_	ἀπαιωρέω_ἀπαιωρέομαι_
φωτός	noun_noun_	φάος_φώς_
ἀκριβῶς	adjective_adverb_verb_	ἀκριβής_ἀκριβῶς_ἀκριβόω_
ὑπεδέξατο	verb_verb_	ὑποδείκνυμι_ὑποδέχομαι_
ἐπιτριβῇ	noun_verb_	ἐπιτριβή_ἐπιτρίβω_
Κυπαρίσσου	noun_noun_	κυπάρισσος_Κυπάρισσος_
Ἀπολλωνίω	adjective_noun_	Ἀπολλώνιος_Ἀπολλώνιον_
λώπη	noun_noun_	λῶπος_λώπη_
Λυγκεὺς	noun_noun_	λυγκεύς_Λυγκεύς_
πειρώμεναι	verb_verb_	πειράω_πειράζω_
ἀπόρροιαν	noun_noun_	ἀπόρροια_ἀπορρόη_
περνάμενα	verb_verb_	περνάω_πέρνημι_
ἠξίωσεν	verb_verb_	ἐξιόω_ἀξιόω_
ἐφόρει	verb_verb_verb_	φορέω_ἐφοράω_ἐποράω_
δέκα	numeral_verb_	δέκα_δεκάω_
δυσμενέων	verb_adjective_	δυσμενέων_δυσμενής_
λάας	verb_verb_	λάω1_λάω2_
πρώτὴν	adjective_adjective_	πρότερος_πρῶτος_
ἀποβολῆς	noun_noun_	ἀποβολή_ἀποβολεύς_
διερεῖ	verb_verb_verb_verb_	διερέω_διερῶ_διεράω_διείρομαι_
πελάγους	verb_noun_	πελαγόω_πέλαγος_
γύοις	noun_noun_	γύος_γύον_
θέων	noun_verb_verb_	θεον_θεάω_θέω_
νεῶν	noun_noun_noun_verb_verb_verb_noun_	νέα_ναός_ναῦς_´ώ_νεάω_νεόω_νεώς_
ὀφείλεις	verb_verb_verb_	ὀφειλέω_ὀφέλλω_ὀφείλω_
ζώσαις	verb_verb_	ζάω_ζώννυμι_
πίλου	verb_noun_	πιλόω_πῖλος_
αὐξήσῃ	noun_verb_	αὔξησις_αὐξάνω_
ὀλίζων	verb_adjective_	ὀλιζόω_ὀλίγος_
συγγένεια	noun_adjective_	συγγένεια_συγγένειος_
Ἀλκαῖος	noun_adjective_	Ἀλκαῖος_ἀλκαῖος_
μάρτυρος	noun_noun_	μάρτυς_μάρτυρος_
Δρύοπας	noun_noun_	δρύοψ_Δρύοψ_
βασιλείας	noun_noun_verb_adjective_	βασιλεία_βασίλεια_βασιλειάω_βασίλειος_
ἀγαπᾶς	verb_verb_	ἀγαπάζω_ἀγαπάω_
Θέμις	noun_noun_	θέμις_Θέμις_
ἐπισείων	noun_verb_	ἐπισείων_ἐπισείω_
σπανίων	noun_adjective_	σπάνις_σπάνιος_
ἢν	exclamation_conjunction_	ἤν_ἐάν_
τύπω	verb_noun_noun_noun_	τυπόω_τύπον_τύπος_τύπης_
πεφυγμένον	verb_verb_	φύζω_φεύγω_
Λίνῳ	noun_noun_noun_noun_	Λῖνος_λίνον_λίνος_Λίνος_
Κριτὰς	adjective_noun_	κριτός_κριτής_
Μοῦσαν	noun_noun_	Μοῦσαι_Μοῦσα_
τιμηθήσῃ	verb_verb_	τιμάω_τιμέω_
βάρει	verb_noun_noun_	βαρέω_βᾶρις_βάρος_
δευτέρους	verb_adjective_	δευτερόω_δεύτερος_
Ἐριῶπις	noun_noun_	ἐριῶπις_Ἐριῶπις_
συντριβῇ	verb_noun_	συντρίβω_συντριβή_
φυτά	noun_adjective_noun_	φυτόν_φυτός_φυτάς_
τρίπος	noun_adjective_	τρίπος_τρίπους_
τόνου	verb_noun_	τονόω_τόνος_
πάσασθαι	verb_verb_verb_	πάομαι_πατέομαι_πάσσω_
ἡνιόχης	noun_verb_	ἡνιόχη_ἡνιοχέω_
μέλαιναν	noun_adjective_	μέλαινα_μέλας_
ναυστάθμου	noun_noun_	ναύσταθμον_ναύσταθμος_
φανῶσι	verb_verb_	φανάω_φαίνω_
νέας	verb_adjective_noun_noun_	νεάω_νέος_νέα_ναῦς_
τευ	pronoun_pronoun_	τις_σύ_
Θράκης	noun_noun_	Θράκη_Θράκευς_
Μέσσην	adjective_noun_	μέσος_Μέσση_
Δημητρίω	adjective_noun_	Δημήτριος_Δημ́ητριος_
πολεμίοις	verb_adjective_	πολεμέω_πολέμιος_
πολεμίων	verb_adjective_	πολεμέω_πολέμιος_
ἐπιπλώω	verb_verb_	ἐπιπλέω_ἐπιπλάζω_
ὑποφονίων	adjective_noun_	ὑποφόνιος_ὑποφόνια_
παρούσης	verb_verb_	παρόω_πάρειμι1_
ἐγδούπησαν	verb_verb_	δουπέω_γδουπέω_
εὐθείαι	noun_adjective_	εὐθεῖα_εὐθύς1_
Ὀϊλεὺς	noun_noun_	Ὀϊλεύς_Ὀιλεύς_
δέω	verb_verb_verb_	δέω2_δεῖ_δέω1_
ἐπιλέξαι	verb_verb_	ἐπί-λέγω3_ἐπί-λέγω1_
κνίση	noun_noun_verb_	κνῖσος_κνῖσα_κνισάω_
φίλους	adjective_verb_noun_	φίλος_φιλόω_φῖλος_
ὅτ'	adverb_conjunction_pronoun_conjunction_pronoun_	ὅτι1_ὅτε_ὅστε_ὅτι2_ὅστις_
ἀπείρατον	adjective_adjective_	ἀπείρατος_ἀπείρητος_
καρτεροῖς	verb_verb_adjective_	καρτερόω_καρτερέω_καρτερός_
προθέουσι	verb_verb_	προθέω_προθέω1_
ἀντιάσαντες	verb_verb_	ἀντιάω_ἀντιάζω_
λέγομεν	verb_verb_verb_	λέγω3_λέγω1_λέγω2_
ἀγορᾶς	noun_verb_	ἀγορά_ἀγοράζω_
λύχνον	noun_noun_	λύχνον_λύχνος_
ἠξίουν	verb_verb_	ἐξιόω_ἀξιόω_
ὑπερβατῷ	adjective_noun_	ὑπερβατός_ὑπερβατόν_
σαώσετον	verb_verb_	σώζω_σαόω_
ἔγχει	noun_verb_verb_	ἔγχος_ἐγχύνω_ἐγχέω_
ἔπεισιν	verb_verb_	ἔπειμι1_ἔπειμι2_
πείση	noun_noun_	πεῖσος_πεῖσις_
ὁδοὺς	noun_noun_	ὁδός1_ὁδός2_
κοινῆς	verb_adjective_	κοινόω_κοινός_
πηγὴ	noun_adjective_	πηγή_πηγός_
δεύοντο	verb_verb_	δεύω2_δεύομαι_
κτήσασθαι	verb_verb_	κτέομαι_κτάομαι_
τελέεσθαι	verb_verb_	τελέω_τέλλω_
Σκυθίας	noun_adjective_noun_	Σκυθία_Σκύθιος_Σκυθίη_
λεγόμενα	verb_verb_verb_	λέγω3_λέγω1_λέγω2_
ἐξυλίσατο	verb_verb_	ἐξυλίζω_ξυλίζομαι_
ἄκραν	adjective_noun_	ἄκρος_ἄκρα_
ψεύδεσσιν	noun_noun_	ψεῦδος_ψεῦδις_
ἑοῦ	adjective_pronoun_	ἑός_ὅς_
ἐθύοντο	verb_verb_	θύω2_θύω1_
ἴδιον	verb_verb_adjective_	ἰδέω_ἰδίω_ἴδιος_
ματήσετον	verb_verb_	ματέω_ματάω_
βράσσων	verb_adjective_	βράσσω_βραδύς_
πρέμνον	noun_noun_	πρέμνος_πρέμνον_
Ἐλάτου	noun_noun_	ἐλάτης_Ἔλατος_
λευκοῦ	verb_adjective_noun_	λευκόω_λευκός_λευκόν_
ἀναιρουμένων	verb_verb_	ἀναιρέω_ἀνιερόω_
Ὀρφέα	noun_noun_	Ὀρφεύς_ὀρφεύς_
Καλλίμαχος	adjective_noun_	καλλίμαχος_Καλλίμαχος_
τεθέατο	verb_verb_	θεάω_θεάομαι_
ποδὶ	noun_noun_	πούς_ποδίς_
ἐνάρκησεν	verb_verb_	ναρκάω_ἐναρκέω_
ἡδοναὶ	noun_noun_	ἡδονή_ἡδονά_
χρέει	noun_verb_	χρέος_χράω2_
παρέχει	verb_verb_	παραχέω_παρέχω_
ἀγασσάμενοι	verb_verb_	ἄγαμαι_ἀγάζω_
βιῶναι	verb_noun_	βιόω_βιώνης_
Ἁλίων	adjective_noun_adjective_adjective_noun_	ἅλιος2_ἥλιος_ἁλής_ἅλιος1_Ἅλις_
ὄφειλε	verb_verb_	ὀφέλλω_ὀφείλω_
ἃ	pronoun_article_	ὅς_ὁ_
¨ἰνίον	noun_verb_verb_	ἰνίον_ἰνέω_ἰνάω_
ἀνθῶν	noun_noun_verb_	ἄνθη_ἄνθος_ἀνθέω_
ἐρρήξαντο	verb_verb_	ῥήγνυμι_ῥήσσω_
Ὠρίων	noun_noun_verb_adjective_	ὦρος_Ὠρίων_ὠρέω_ὤριος_
πέλωρα	adjective_noun_	πέλωρος_πέλωρον_
τιμᾷ	verb_noun_	τιμάω_τιμή_
φυτῷ	noun_adjective_	φυτόν_φυτός_
καταχρῆται	verb_verb_	καταχράομαι_καταχράω_
ὑπερβατόν	noun_adjective_	ὑπερβατόν_ὑπερβατός_
ἀπαλλαγῆναι	verb_verb_	ἀπαλλάσσω_ἀπαλλαξείω_
θανάτους	noun_verb_	θάνατος_θανατόω_
δοκοῦσιν	verb_noun_verb_	δοκέω_δοκώ_δοκόω_
φρουρῶν	noun_verb_noun_	φρουρός_φρουρέω_φρουρά_
λιασθεὶς	verb_verb_	λιάζω_λιάζομαι_
ῥοφεῖν	verb_verb_	ῥοφέω_ῥοφάω_
δωσόντων	noun_verb_	δώσων_δίδωμι_
νεώτερος	adjective_adjective_	νέος_νεώτερος_
ἐμοί	adjective_pronoun_	ἐμός_ἐγώ_
σιάλοιο	noun_noun_	σίαλος_σίαλον_
ἐξόδου	adjective_noun_	ἔξοδος2_ἔξοδος1_
θεῶν	noun_noun_verb_	θεά_θέα_θεάω_
σφώ	pronoun_adjective_pronoun_	σύ_σφός_σφεῖς_
ἐναντὶον	adverb_adjective_	ἐναντίον_ἐναντίος_
ἐναντιούμενον	ἀντί-ἰό_ἀνά-τίζ_verb_verb_ἀντί-ἱέ_ἀντί-ἰόομα_	ἐν_ἐν_ἐν-ἀντιόομαι_ἐν-ἐναντιόομαι_ἐν_ἐν_
οἲ	noun_exclamation_	ὄις_οἰ_
φῶτα	noun_noun_	φώς_φάος_
στίχοις	noun_verb_	στίχος_στείχω_
φύσιν	noun_verb_verb_	φύσις_φύς_φύω_
σύμφυτον	noun_adjective_verb_	σύμφυτον_σύμφυτος_συμφύω_
ποινῆς	noun_verb_	ποινή_ποινάω_
σθένιος	noun_noun_	σθένος_σθένιος_
Θεόφραστος	adjective_noun_	θεόφραστος_Θεόφραστος_
ποιοῦσα	verb_verb_	ποιόω_ποιέω_
ὅμοιόν	adjective_adjective_	ὁμοῖος_ὅμοιος_
πνευμάτων	noun_verb_	πνεῦμα_πνευματόω_
μής	noun_noun_	μείς_μής_
οὐρανῶ	noun_verb_	οὐρανός_οὐρανόω_
Κίλλου	noun_noun_	κίλλος_Κίλλη_
ἰῇ	verb_adjective_verb_noun_	ἰάομαι_εἷς_ἰάζω_ἰά_
κατασκευῇ	noun_verb_	κατασκευή_κατασκευάζω_
ἔπεσσον	verb_verb_	πέσσω_ἐφίζω_
ἐπιόντων	verb_verb_	ἔπειμι2_ἔπειμι1_
ἀπειλεῖν	verb_verb_verb_	ἀπειλέω2_ἀπειλέω_ἀπειλέω1_
Πρωτέως	noun_noun_	πρωτεύς_Πρωτεύς_
κρέοντος	noun_noun_	κρέων_κρείων_
Κίλλαν	noun_noun_	Κίλλη_Κίλλα_
Ἡμέρας	noun_adjective_	ἡμέρα_ἥμερος_
κακοῖς	adjective_verb_	κακός_κακόω_
ἔνδον	adverb_verb_	ἔνδον_ἐνδίδωμι_
πολίων	noun_verb_noun_verb_noun_	πόλις_πολέω_πόόλις_πολιόω_πόλιον_
Πήγασον	noun_verb_	Πήγασος_πηγάζω_
Πύλῳ	noun_noun_	Πύλος_πύλος_
λέξον	verb_verb_verb_	λέγω1_λέγω2_λέγω3_
κῆλα	noun_noun_	κῆλον_κήλας_
λόγου	verb_noun_	λογόω_λόγος_
ζωάγρια	adjective_noun_	ζωάγριος_ζωάγρια_
ἱδρῶ	noun_verb_	ἱδρώς_ἱδρόω_
πορφυροῦν	verb_verb_adjective_	πορφυρέω_πορφύρω_πορφύρεος_
γονάτων	verb_noun_	γονάω_γόνυ_
δαῖὲ	verb_verb_	δαίω1_δαίω2_
ἄκρῃ	noun_noun_adjective_	ἄκρις_ἄκρα_ἄκρος_
κλίνῃ	verb_noun_	κλίνω_κλίνη_
πλείων	verb_adjective_adjective_	πλέω_πλέως_πλείων_
τόνους	noun_verb_	τόνος_τονόω_
ἔλεγεν	verb_verb_verb_	λέγω2_λέγω1_λέγω3_
Σκήψιος	noun_noun_	Σκήψιος_σκῆψις_
φοιτῶσα	verb_verb_	φοιτάζω_φοιτάω_
δέξατό	verb_verb_	δέχομαι_δείκνυμι_
γένναι	noun_noun_	γέννας_γέννα_
πρώτης	adjective_adjective_	πρῶτος_πρότερος_
οἰκείω	verb_verb_verb_adjective_	οἰκειόω_οἰκείω_οἰκέω_οἰκεῖος_
ξένοις	noun_adjective_	ξένος1_ξένος2_
σπῆϊ	verb_verb_	σπάω_ἕπομαι_
λεχθέν	verb_verb_	λέγω2_λέγω3_
πλάγιον	adjective_noun_	πλάγιος_πλάγιον_
δεδμήμεσθα	verb_verb_	δέμω_δαμάζω_
ἐπεισόδια	adjective_noun_	ἐπεισόδιος_ἐπεισόδιον_
Γάργαρον	noun_noun_	Γάργαρον_Γάργαρος_
Κεφαλληνίας	noun_adjective_noun_	Κεφαλληνία_Κεφαλλήνιος_Κεφαλληνίη_
παλαιοῦ	verb_adjective_	παλαιόω_παλαιός_
Κόλχους	noun_noun_	Κόλχος_κόλχος_
ἄρχοντος	noun_verb_	ἄρχων_ἄρχω_
θύρσους	verb_noun_	θυρσόω_θύρσος_
νεῦσ'	verb_verb_verb_noun_verb_verb_	νεύω_νέω2_νέω1_νεῦσις_νέω3_νέω_
Ὦρος	noun_noun_	Ὦρος_ὦρος_
ἀντιόωντες	verb_verb_	ἀντιάζω_ἀντιάω_
ἀνάξιος	noun_adjective_	ἄναξις_ἀνάξιος_
μόνων	verb_adjective_	μονόω_μόνος_
βιώσονται	verb_verb_	βιόω_βιώσκομαι_
Ἄγριος	adjective_noun_	ἄγριος_Ἄγριος_
ἐμῶ	verb_verb_adjective_	ἐμέω_μάομαι_ἐμός_
Μέδων	noun_noun_noun_verb_	μέδος_Μέδων_μέδων_μέδω_
κάμωσιν	noun_verb_	κάμων_κάμνω_
υἱοῦ	verb_noun_	υἱόω_υἱός_
μικρὰν	adjective_adjective_	σμικρός_μικρός_
Ποσειδώνιον	adjective_noun_	Ποσειδώνιος_Ποσειδώνιον_
δέελον	adjective_adjective_	δῆλος_δέελος_
καρδίαν	noun_verb_	καρδία_καρδιάω_
Χάος	noun_noun_	Χάος_χάος_
πλήθει	verb_noun_	πλήθω_πλῆθος_
θύτην	noun_noun_	θυτήρ_θύτης_
ῥᾶσθαι	verb_verb_	ῥάζω_ῥαίνω_
ὦ	verb_exclamation_	εἰμί_ὦ_
ὁμωνυμίας	adjective_noun_adjective_	ὁμωνύμιος_ὁμωνυμία_ὁμώνυμος_
Δίδυμος	noun_adjective_	Δίδυμος_δίδυμος_
σαρκοφάγων	adjective_adjective_	σαρκοφάγος_σαρκόφαγος_
πανούργου	adjective_adjective_	πανοῦργος_πάνουργος_
ἐξηλέησεν	verb_verb_	ἐκ-ἐλεάω_ἐκ-ἐλεέω_
σκότους	noun_verb_	σκότος_σκοτόω_
κομείτων	verb_verb_	κομέω_κομάω_
αὐτοῦ	pronoun_adverb_	αὐτός_αὐτοῦ_
θεῖναι	verb_verb_	θείνω_τίθημι_
ἐλέλιχθεν	verb_verb_	ἐλελίζω2_ἐλελίζω1_
ἆθλον	noun_noun_	ἆθλος_ἆθλον_
συντάξεις	verb_verb_noun_	συντήκω_συντάσσω_σύνταξις_
χρεία	noun_noun_	χρεία_χρέος_
Ἀρίσταρχos	noun_noun_	Ἀρίσταρχος_ἀρίσταρχος_
γνησίους	verb_adjective_	γνησιόω_γνήσιος_
θέαι	noun_verb_verb_	θέα_τίθημι_θέω_
τετρωμένων	verb_verb_	τετράζω_τιτρώσκω_
ἠέλιον	noun_noun_	ἥλιος_ἠέλιος_
πρώτη	adjective_adjective_	πρῶτος_πρότερος_
Ὕλη	verb_noun_noun_noun_	ὑλάω_Ὕλη_ὗλις_ὕλη_
ἐρρίγουν	verb_verb_verb_	ἐνριγόω_ῥιγόω_ῥιγέω_
Ἀλεξάνδροιο	noun_adjective_	Ἀλέξανδρος_ἀλέξανδρος_
Βορέας	noun_noun_	Βορέας_Βορέης_
δεομένῳ	verb_verb_verb_	δέω2_δέομαι_δέω1_
προτάξας	verb_verb_	προτάσσω_προσάγω_
προσίσασιν	verb_verb_	προσίζω_πρόσοιδα_
ἐποιοῦντο	verb_verb_	ποιόω_ποιέω_
μανιοποιοῦ	adjective_verb_	μανιοποιός_μανιοποιέω_
ἀρὰ	noun_noun_	ἀρή_ἀρά_
ἑπτ'	numeral_noun_	ἑπτά_ἑπτάς_
ἡνιοχεῖ	noun_verb_	ἡνιοχεύς_ἡνιοχέω_
ὑπηρέτιδες	noun_noun_	ὑπήρετις_ὑπηρέτις_
πύργου	noun_verb_	πύργος_πυργόω_
ῥοάς	noun_noun_	ῥοή_ῥοάς_
πλέον	verb_adjective_adjective_adjective_	πλέω_πλέος_πλπλείων_πλείων_
μέλισσαν	noun_verb_	μέλισσα_μελίζω_
διακεῖσθαι	verb_verb_	διάκειμαι_διακέομαι_
καταδύνει	verb_verb_	καταδύνω_καταδύω_
ἁπάτη	verb_noun_verb_	ἀπατάω_ἀπάτη_πατέω_
τ᾽	particle_pronoun_	τε_σύ_
δέξατο	verb_verb_	δείκνυμι_δέχομαι_
Πολυδέκτου	noun_noun_	πολυδέκτης_Πολυδέκτης_
ναῖε	verb_verb_	ναίω2_ναίω1_
προθέων	verb_verb_	προθέω1_προθέω_
νεώμεθα	verb_verb_verb_verb_verb_verb_	νέομαι_νεάω_νέω_´ώ_νεόω_νέω3_
τροφῶν	verb_verb_noun_noun_	τροφέω_τρέφω_τροφή_τροφός_
Θυέστης	noun_noun_	θυέστης_Θυέστης_
ὄρνεα	noun_noun_	ὄρνεον_ὄρνις_
ἐλέγχει	verb_noun_	ἐλέγχω_ἔλεγχος1_
χάζετο	verb_verb_	χάζω_χάζομαι_
πρῶτα	adjective_adjective_	πρῶτος_πρότερος_
ἅμμε	noun_noun_	ἄμμος_ἅμμος_
χρειοῖ	verb_noun_	χρείζω_χρεώ_
τώ	article_adverb_	ὁ_τῷ_
Μέση	noun_adjective_noun_noun_	μέση_μέσος_Μέση_μέσης_
ἐρέει	verb_verb_verb_verb_	ἔρομαι_ἐρέομαι_ἐρέω_ἐρῶ_
καθὲν	adverb_verb_	καθέν_καθίημι_
ἱπποσυνάων	noun_adjective_	ἱπποσύνη_ἱππόσυνος_
κεραυνίου	noun_noun_adjective_noun_	κεραυνίας_κεραας_κεραύνιος_κεραύνιον_
ἐμεῦ	pronoun_verb_	ἐγώ_ἐμέω_
χαλκῶ	adjective_noun_verb_	χάλκεος_χαλκοῦς_χαλκόω_
ἐνεργῶς	adjective_adjective_	ἐνεργής_ἐνεργός_
ξείνων	adjective_verb_noun_	ξένος2_ξενόω_ξένος1_
στίχοι	noun_verb_	στίχος_στείχω_
φοιτᾷ	verb_verb_	φοιτάω_φοιτάζω_
φαρμάκῳ	noun_noun_	φάρμακον_φάρμακος_
πένης	verb_noun_	πενέω_πένης_
Ἀττικῇ	noun_adjective_	Ἀττική_Ἀττικός_
μέδοντες	noun_verb_	μέδων_μέδω_
νεμέσσει	verb_noun_	νεμεσάω_νέμεσις_
χείριστε	adjective_adjective_	χείριστος_χείρων_
Χρύσου	verb_noun_	χρυσόω_Χρύσης_
χαριζόμενον	verb_verb_	χαρίζω_χαρίζομαι_
Πόντου	noun_verb_verb_noun_	Πόντος_ποντόω_ποντίζω_πόντος_
Ἄνιος	noun_adjective_	Ἄνιος_ἄνιος_
δειλία	verb_noun_	δειλιάω_δειλία_
ἠελίοιο	noun_noun_	ἠέλιος_ἥλιος_
εἰσιδέειν	verb_verb_	εἰσ-εἶδον_εἰσ-ἰδέω_
ἐν	preposition_preposition_	ἐν_εἰς_
τόθ'	adverb_adverb_	τότε_τόθι_
Ἀΐδην	verb_noun_	ἀείδω_Ἅιδης_
χρῆσιν	verb_verb_noun_	χράω2_χράομαι_χρῆσις_
Ἀλέξανδρον	noun_adjective_	Ἀλέξανδρος_ἀλέξανδρος_
ἀγαθῶν	adjective_verb_	ἀγαθός_ἀγαθόω_
ἵλαοι	adjective_adjective_	ἴλαος_ἵλαος_
ἀντίθετον	verb_verb_adjective_	ἀνατίθημι_ἀντιτίθημι_ἀντίθετος_
ξεινοδόκον	noun_noun_	ξενοδόκος_ξεινοδόκος_
παραιρεῖται	verb_verb_	παραιρέω_παραρρέω_
τῇδε	adverb_pronoun_	τῇδε_ὅδε_
ἀλεώμεθα	verb_verb_verb_verb_	ἀλάομαι_ἀλέομαι_ἀλεάζω_ἀλέω_
Ζεφυρίῳ	noun_noun_	Ζεφύριον_Ζεφύριος_
Κλυμένη	adjective_noun_	κλύμενος_Κλυμένη_
ἐρωτήσει	verb_noun_	ἐρωτάω_ἐρώτησις_
μέσην	noun_adjective_noun_	μέση_μέσος_μέσης_
κατασχεῖν	verb_verb_	κατασχάω_κατέχω_
χαίτην	noun_verb_	χαίτη_χάω_
Γανυμήδης	noun_noun_	Γανυμήδη_Γανυμήδης_
φυλάσσοντες	verb_verb_	φυλάζω_φυλάσσω_
ῥέων	noun_verb_	ῥέον_ῥέω_
λιτή	adjective_noun_	λιτός_λιτή_
ἔταξαν	verb_verb_	τάσσω_ἐτάζω_
ἔσπετε	verb_verb_verb_verb_	ἔσπον_ἕπομαι_εἰσπίπτω_εἶπον_
πλεῖν	verb_adjective_	πλέω_πλείων_
μελαίνῃσι	adjective_noun_verb_	μέλας_μέλαινα_μελαίνω_
ὑποπτεύσας	verb_verb_	ὑποπτεύω_ὑποπτάω_
δῆσεν	verb_verb_	δέω2_δέω1_
ὀνήσεται	verb_verb_verb_	ὀνιμι_ὀνέομαι_ὀνίνημι_
βιασαμένου	verb_verb_	βιάζω_βιάω_
ὑπάτῃ	noun_adjective_	ὑπάτη_ὕπατος_
πυκνὸς	adjective_noun_	πυκνός_πνύξ_
ἔχεις	verb_verb_noun_verb_	χέω_ἔχω_ἔχις_χάω_
φυλάσσουσι	verb_verb_	φυλάζω_φυλάσσω_
Κρόνου	noun_noun_	κρόνος_Κρόνος_
κόρσην	noun_noun_	κόρση_κόρσης_
ἔπει	noun_verb_	ἔπος_ἔπειμι2_
νήσω	verb_verb_noun_verb_	νέω3_νέω2_νῆσος_νέω_
λὶς	noun_noun_	λίς2_λίς1_
φαρμάκων	verb_noun_noun_	φαρμακάω_φάρμακος_φάρμακον_
ψιλῶν	adjective_verb_	ψιλός_ψιλόω_
ῥινοῖς	verb_verb_noun_verb_noun_	ῥινέω_ῥινόω_ῥινόν_ῥινάω_ῥινός_
σφυρά	noun_noun_	σφυρόν_σπυράς_
λύθρῳ	noun_noun_	λύθρον_λύθρος_
λήθη	noun_noun_	λῆθος_λήθη_
ὀνύχων	noun_verb_	ὄνυξ_ὀνυχόω_
ὑποτρόχων	verb_adjective_	ὑποτροχάω_ὑπότροχος_
πλαγίου	noun_adjective_verb_	πλάγιον_πλάγιος_πλαγιόω_
ὑπόδρα	adverb_verb_verb_	ὑπόδρα_ὑποδράω_ὑποδρώω_
πολιοῖο	verb_adjective_verb_	πολίζω_πολιός_πολιόω_
τοῦ	pronoun_article_irregular_	τις_ὁ_τίς_
χωρίον	verb_noun_	χωρέω_χωρίον_
σκυτοτόμων	noun_noun_	σκυτοτόμος_σκυτότομος_
ἐρεῖ	verb_verb_verb_	ἐράομαι_ἐρέω_ἐρέομαι_
πόρον	verb_noun_	πόρω_πόρος_
Αἰόλου	adjective_noun_	αἰόλος_Αἴολος_
φυλάσσων	verb_verb_	φυλάσσω_φυλάζω_
ναῖ᾽	verb_verb_	ναίω2_ναίω1_
κόρυθ'	noun_noun_	κόρυς_κόρυθος_
ἀρίστω	adjective_noun_	ἄριστος_ἄριστον_
δαμεῖς	verb_verb_	δαμάω_δαμάζω_
καθέζονται	verb_verb_	κατά-καθέζομαι_κατά-ἕζομαι_
ἀρτῶ	verb_verb_	ἀρτάω_ἀρτέομαι_
Δίκτυϊ	noun_noun_	δίκτυς_Δίκτυς_
παθῶν	noun_noun_	πάθη_πάθος_
ἀναγκαῖα	adjective_adjective_	ἀναγκαῖος_ἀναγκαῖον_
πρόεισιν	verb_verb_	πρόειμι2_πρόειμι1_
ψιλοῦ	adjective_verb_	ψιλός_ψιλόω_
ἀπόφασιν	verb_noun_noun_	ἀπόφημι_ἀπόφασις2_ἀπόφασις1_
φυτῶν	noun_adjective_	φυτόν_φυτός_
ἐλαίω	noun_verb_verb_noun_	ἔλαιος_ἐλαύνω_ἐλαιόω_ἔλαιον_
οὐδοῦ	noun_noun_	οὐδός1_οὐδός2_
σῆς	verb_noun_adjective_	σέω_σής_σός_
κούρη	noun_verb_noun_	κόρη_ἐπικουρέω_κουρά_
θανάτω	verb_noun_	θανατόω_θάνατος_
πρώτην	adjective_adjective_	πρότερος_πρῶτος_
ταχυτέρους	adjective_adjective_	ταχύς_ταχύτερος_
ἄξαντ'	verb_verb_	ἄγω_ἄγνυμι_
συνέχει	verb_verb_	συγχέω_συνόχωκα_
Ἥλιον	noun_noun_	Ἥλιος_ἥλιος_
πῆ	particle_noun_	πη_πῆ_
κουλεῷ	noun_noun_noun_	κουλεός_κολεόν_κουλεόν_
Δίδυμον	adjective_noun_	δίδυμος_Δίδυμος_
δεῖν	verb_verb_verb_	δέω1_δεῖ_δέω2_
στίχων	noun_verb_	στίχος_στιχάομαι_
ἐκδεξάμενος	verb_verb_	ἐκδέχομαι_ἐκδείκνυμι_
Θαλείας	noun_noun_	θάλεια_Θάλεια_
θηρίον	noun_verb_	θηρίον_θηράω_
θέαν	verb_noun_	θεάω_θέα_
καρτερῶς	verb_adjective_	καρτερόω_καρτερός_
μικρῶν	adjective_adjective_	σμικρός_μικρός_
νεοίμην	verb_verb_verb_verb_	νέομαι_νέω3_νεόω_νέω_
δεινοὶ	verb_adjective_	δεινόω_δεινός_
Δεῖμόν	verb_noun_	δέμω_Δεῖμος_
πετωμένων	verb_verb_verb_verb_	πετάομαι_πετάω_πετάννυμι_πετάζω_
Αἴας	noun_noun_noun_	Αἶα_Αἴας_αἶα_
Ἴ̈ρις	noun_noun_	ἶρις_Ἴρις_
θερμῶς	adjective_verb_	θερμός_θερμόω_
ἀπειλήσει	verb_verb_verb_noun_	ἀπειλέω_ἀπειλέω1_ἀπειλέω2_ἀπείλησις_
Καύκωνες	noun_noun_	Καύκων_Καύκωνες_
ψύχει	noun_verb_	ψῦχος_ψύχω_
ἐξοχῶ	verb_verb_	ἐκ-ὀχάομαι_ἐκ-ὀχέω_
ἀμέτρητον	adjective_adjective_	ἀμετρητος_ἀμέτρητος_
παλαιοὶ	verb_adjective_	παλαιόω_παλαιός_
πέμπε	numeral_verb_	πέντε_πέμπω_
χρεῖοσ	adjective_noun_	χρεῖος_χρέος_
ἰνίον	verb_verb_noun_	ἰνέω_ἰνάω_ἰνίον_
κεκαφηότα	verb_verb_	κεκαφηώς_κάπτω_
Βοιωτίᾳ	adjective_noun_	Βοιώτιος_Βοιωτία_
πλησίον	adverb_verb_	πλησίος_πίμπλημι_
νεκροὶ	adjective_verb_	νεκρός_νεκρόω_
κρείσσων	verb_adjective_	κρεισσόω_κρείσσων_
κεκτημέναι	verb_verb_	κτάομαι_κτέομαι_
περιειλήσας	verb_verb_	περιείλω_περιειλέω_
Λύκων	verb_noun_noun_noun_	λυκόω_Λύκων_λύκος_Λων_
κατέχει	verb_verb_	καταχέω_κατέχω_
κοίλῃσι	adjective_adjective_	κοῖλος_κόιλος_
οὐδ᾽	particle_noun_noun_	οὐδέ_οὐδός2_οὐδός1_
συγκαταλέξαι	κατά-ἀλέξ_verb_κατά-λέγω_	σύν_σύν-καταλέγω_σύν_
διαστάσεις	noun_verb_verb_	διάστασις_διαστάζω_διίστημι_
ἀπαλοῖς	verb_verb_	ἀπό-ἀλόω_ἀπό-ἀλέω_
ἰθύς	adjective_adverb_	εὐθύς1_ἰθύς1_
θηρῶν	noun_verb_noun_	θήρ_θηράω_θήρα_
τύχῃσι	verb_noun_	τυγχάνω_τύχη_
ἐλάττους	adjective_verb_	ἐλάσσων_ἐλασσόω_
δεῖσθαι	verb_verb_verb_	δέω1_δέομαι_δέω2_
πλάγιος	noun_adjective_	πλάγος_πλάγιος_
λάχῃ	noun_verb_	λάχη_λαγχάνω_
αἳ	article_pronoun_	ὁ_ὅς_
δόξαι	noun_verb_	δόξα_δοκέω_
κείω	verb_verb_verb_	κείω1_καίω_κείω2_
δαμῶ	verb_verb_	δαμάω_δαμάζω_
κάη	verb_noun_	καίω_κάος_
διανεμήσει	noun_verb_	διανέμησις_διανέμω_
Ἴριδος	noun_noun_	Ἴρις_Ἶρις_
λέγ'	verb_adjective_verb_verb_	λέγω2_λέγος_λέγω1_λέγω3_
συνθέτων	verb_adjective_	συντίθημι_σύνθετος_
στάθμη	noun_verb_	στάθμη_σταθμάω_
ὁμοίων	adjective_adjective_verb_	ὁμοῖος_ὅμοιος_ὁμοιόω_
παιπάλη	noun_verb_	παιπάλη_παιπαλάω_
ὁρμῆσαι	verb_verb_	ὁρμέω_ὁρμάω_
πείσῃ	noun_noun_verb_verb_	πεῖσις_πεῖσα_πείθω_πάσχω_
ὁδὸς	noun_noun_	ὁδός2_ὁδός1_
πολίχνιον	noun_noun_	πολίχνιον_πολίχνη_
δευτέρου	adjective_verb_	δεύτερος_δευτερόω_
ἐπίπλουν	verb_verb_noun_	ἐπιπλέω_πίμπλημι_ἐπίπλοος2_
ἐέρση	verb_noun_	ἔρσε_ἔρσα_
κλήρους	noun_verb_	κλῆρος_κληρόω_
ἐπισσώτρων	noun_noun_	ἐπίσσωτρον_ἐπίσωτρον_
Ὕδῃ	noun_noun_	ὕδης_Ὕδη_
ἀνδρείων	verb_noun_adjective_	ἀνδρειόω_ἀνδρεῖα_ἀνδρεῖος_
πινυτή	adjective_noun_	πινυτός_πινυτή_
κατασπασθεῖσα	verb_verb_	κατασπάω_κατασπάζομαι_
τράγου	noun_verb_verb_	τράγος_τρώγω_τράγω_
σίδηρον	noun_noun_	σίδηρος_σίδηρον_
ἅπορον	verb_adjective_	πόρω_ἄπορος_
λείαν	adjective_noun_	λεῖος_λεία_
ὀπάων	noun_noun_	ὀπή_ὀπάων_
κατανεῦσαι	verb_verb_	κατανέω_κατανεύω_
ἐπισταμένῳ	verb_verb_verb_	ἐφίστημι_ἐπίσταμαι_ἐπιστάζω_
κεραυνοῦ	verb_noun_	κεραυνόω_κεραυνός_
πόσε	adjective_adverb_	πόσος_πόσε_
κούρης	noun_verb_noun_	κουρά_ἐπικουρέω_κόρη_
πεινάων	noun_verb_	πεῖνα_πεινάω_
Ἀσίαν	noun_adjective_adjective_noun_	Ἀσία_Ἄσιος_ἄσιος_Ἀσίας_
ἀργύρου	noun_verb_	ἄργυρος_ἀργυρόω_
συνέδησε	verb_verb_	συνδέω_συνδέομαι_
οἰκείως	verb_adjective_	οἰκειόω_οἰκεῖος_
δίνῃ	verb_noun_	δίνω_δίνη_
ἐφεξῆς	adverb_verb_	ἐφεξῆς_ἐπώχατο_
νεκροῖσιν	verb_adjective_	νεκρόω_νεκρός_
τρόπω	noun_verb_	τρόπος_τροπόω_
ἐπιστάμεθα	verb_verb_verb_	ἐφίστημι_ἐπίσταμαι_ἐπιστάζω_
παρασκευάσῃ	noun_verb_	παρασκεύασις_παρασκευάζω_
μόρια	noun_adjective_	μόριον_μόριος_
ἡγήσατο	verb_verb_	ἡγέομαι_ἁγέομαι_
ἔτισαν	verb_verb_	τίζω_τίνω_
ἄξοντα	verb_verb_	ἄγω_ἄγνυμι_
στρατῷ	verb_noun_	στρατάω%2_στρατός_
Μελάνιππος	noun_adjective_	Μελάνιππος_μελάνιππος_
σπάθη	noun_verb_	σπάθη_σπαθάω_
κατώτατον	adjective_adjective_	κατώτατος_κάτος_
ἐμέθεν	pronoun_verb_	ἐγώ_μεθίημι_
λίμνη	noun_noun_	λιμνει_λίμνη_
ἄχεϊ	verb_noun_verb_	ἠχέω_ἄχος_ἀχεύω_
συμμαχήσει	verb_verb_	συμμαχέω_συμμάχομαι_
πλευρὰ	noun_noun_	πλευρά_πλευρόν_
Λυκίας	noun_adjective_	Λυκία_Λύκιος_
μέσου	adjective_noun_verb_	μέσος_μέσης_μεσόω_
γονεῖς	noun_verb_	γονεύς_γονάω_
δυστυχεῖς	verb_adjective_	δυστυχέω_δυστυχής_
νεωτέροις	adjective_adjective_	νεώτερος_νέος_
τελευτῇ	noun_verb_	τελευτή_τελευτάω_
λεπτὸν	adjective_noun_	λεπτός_λεπτόν_
πυρῆς	noun_verb_noun_	πυρεύς_πυράζω_πυρή_
λέγοντος	verb_verb_verb_	λέγω1_λέγω3_λέγω2_
εὐθείας	adjective_noun_	εὐθύς1_εὐθεῖα_
ἔπαυσεν	verb_verb_	ἐπαύω_παύω_
αἰτία	noun_adjective_	αἰτία_αἴτιος_
μεθ'	adverb_adverb_preposition_	μεταί_μεθό_μετά_
θερμῆς	adjective_verb_	θερμός_θερμάζω_
ὕλη	noun_noun_verb_	ὕλη_ὗλις_ὑλάω_
παρορμῆσαι	verb_verb_	παρορμάω_παρορμέω_
κέρδιον	adjective_verb_	κερδίων_κερδαίνω_
ἔλαβεν	verb_verb_	λαμβάνω_λάπτω_
Μαῖαν	noun_noun_	Μαῖα_μαῖα_
μετιόωσιν	verb_verb_	μετά-ἰόω_μετά-ἰάζω_
ἄρω	verb_verb_noun_verb_	ἀείρω_αἴρω_ἄρον_ἀρόω_
πετῶ	verb_verb_verb_verb_	πετάζω_πετάομαι_πετάννυμι_πετάω_
Ἡρακλειδῶν	noun_noun_	Ἡρακλείδης_Ἡρακλείδαι_
ἐπαρθεὶς	verb_verb_	ἐπαίρω_ἐπαραρίσκω_
πρέποντος	noun_verb_	πρέπων_πρέπω_
Ἀττικῆς	adjective_noun_	Ἀττικός_Ἀττική_
κλέπτῃ	noun_verb_	κλέπτης_κλέπτω_
ὁμοίας	adjective_adjective_	ὁμοῖος_ὅμοιος_
ἐπίσχοιμι	verb_verb_	ἐπίσχω_ἐπώχατο_
συνθέτου	adjective_noun_	σύνθετος_συνθέτης_
φανῇ	adjective_verb_noun_verb_	φανός1_φανάω_φανή_φαίνω_
τίμησόν	verb_verb_	τιμάω_τιμέω_
Ἀσίου	noun_adjective_adjective_	Ἀσίας_ἄσιος_Ἄσιος_
φυξίῳ	adjective_noun_	φύξιος_φύξιον_
δαίω	adjective_verb_verb_verb_	δάιος_δαίω1_δᾳόω_δάω_
σιωπῆς	verb_noun_	σιωπάω_σιωπή_
ἱερὰν	adjective_noun_	ἱερός_ἱερά_
προσεκτικὸς	adjective_verb_	προσεκτικός_προσκτίζω_
ἀπείρῳ	adjective_noun_adjective_	ἄπειρος1_ἤπειρος_ἄπειρος2_
γλυκίω	adjective_adjective_	γλύκιος_γλυκύς_
ἐπιστάμενοι	verb_verb_verb_	ἐπιστάζω_ἐπίσταμαι_ἐφίστημι_
μεσημβρίας	verb_noun_adjective_	μεσημβριάω_μεσημβρία_μεσήμβριος_
ἀπόεικε	verb_verb_	ἀποείκω_ἀπεοικώς_
Ἀνδρομάχην	adjective_noun_	ἀνδρομάχος_Ἀνδρομάχη_
ἐπάσαντο	verb_verb_verb_verb_	πατέομαι_πάομαι_πάσσω_ἐφήδομαι_
ἀραῖς	noun_noun_	ἀρή_ἀρά_
ποιμνίοις	noun_adjective_	ποίμνιον_ποίμνιος_
εἰκὸς	verb_verb_	ἔοικα_εἰκός_
Ἀθήνην	noun_noun_	Ἀθήνη_Ἀθῆναι_
καταθύμιον	verb_adjective_	καταθυμέω_καταθύμιος_
σπάνιος	noun_adjective_	σπάνις_σπάνιος_
ἀπείρωσ	adjective_verb_noun_adjective_	ἄπειρος1_ἀπειρόω_ἤπειρος_ἄπειρος2_
ἰῆς	noun_verb_adjective_	ἰά_ἰάζω_εἷς_
εἴασεν	verb_verb_	εἰάζω_ἐάω_
προστάσσω	verb_verb_	προσστάζω_προστάσσω_
τέλειον	verb_adjective_	τελέω_τέλειος_
ἐπιθεῖτε	verb_verb_verb_	ἐπιθέω_ἐπιτίθημι_πιθέω_
ἐμῇ	verb_adjective_	ἐμέω_ἐμός_
δεχθῆναι	verb_verb_	δείκνυμι_δέχομαι_
ἀκούσαι	verb_adjective_verb_	ἀκέω_ἀέκων_ἀκούω_
δεκτέον	adjective_adjective_	δεκτέον_δεκτέος_
ἠλέησε	verb_verb_	ἐλεέω_ἐλεάω_
δοκοῖεν	verb_verb_	δοκόω_δοκέω_
Ἀθηνᾶν	noun_noun_	Ἀθήνη_Ἀθῆναι_
χρυσάορα	adjective_noun_	χρυσάορος_χρυσάωρ_
οὔθ'	adverb_pronoun_adverb_	οὔτε_οὔτις_οὔτι_
ὣς	conjunction_pronoun_	ὡς_ὅς_
σκοπεῖ	verb_verb_	σκοπέω_σκοπάω_
Γόρτυνά	noun_noun_	Γόρτυς_Γόρτυνα_
Ὕλλῳ	noun_noun_	Ὕλλος_ὕλλος_
ἅβλητον	adjective_verb_	ἄβλητος_βάλλω_
στρεπτοῖο	adjective_noun_	στρεπτός_στρεπτόν_
κονίσσουσιν	verb_verb_	κονίζω_κονίω_
φανερῶ	verb_adjective_	φανερόω_φανερός_
ἔλυσαν	verb_verb_	λύω_ἐλύω_
Μῆλον	noun_noun_adjective_	μῆλον1_μῆλον2_Μῆλος_
Κρητάων	noun_noun_	κρήτη_Κρήτη_
σοῖσι	verb_adjective_	σέω_σός_
ἐπιμάρτυρος	noun_noun_	ἐπιμάρτυς_ἐπιμάρτυρος_
μυσαχθεῖσα	verb_verb_	μυσάζω_μυσάττομαι_
χειμάρρω	adjective_adjective_	χείμαρρος_χειμάρρους_
ἐνειλεῖσθαι	verb_verb_	ἐνειλέω_ἐνείλλω_
μικρᾶς	adjective_adjective_	σμικρός_μικρός_
νηοῦ	verb_noun_	νηέω_ναός_
πότ'	noun_noun_noun_noun_particle_	πότος_πότης_πότις_πότε_ποτέ_
σχῇ	verb_verb_verb_	σχάω_σχάζω_ἔχω_
νεώτατος	adjective_adjective_	νέος_νεώτατος_
ἔρραψε	verb_verb_	ῥάπτω_ἐνράπτω_
νάπη	noun_noun_	νάπος_νάπη_
φορά	adjective_noun_	φορός_φοράς_
ἀερσίποδες	adjective_adjective_	ἀρσίπους_ἀερσίπους_
κορύνης	noun_verb_	κορύνη_κορυνάω_
Ἑλένῃ	noun_noun_	ἑλένη_Ἑλένη_
παγέντες	verb_verb_	πήγνυμι_πάσσω_
Φρίξου	noun_noun_	φρῖξος_Φρίξος_
ἔχευεν	verb_verb_	χεύω_χέω_
κορυφῇσι	noun_verb_	κορυφή_κορύπτω_
ἁπῆλθον	verb_verb_	ἐπέρχομαι_ἀπέρχομαι_
τροφῇ	noun_noun_verb_verb_	τρόφις_τροφή_τρέφω_τροφέω_
εἴατο	verb_verb_	εἰμί_ἐάω_
Θύμβρα	noun_noun_noun_	Θύμβρης_θύμβρα_θύμβρον_
κέωνται	verb_verb_	κέω_κεῖμαι_
νοήσῃ	verb_noun_	νοέω_νόησις_
δεξιᾶς	verb_noun_adjective_	δεξιάζω_δεξιά_δεξιός_
φάρμαχ'	noun_noun_	φάρμακος_φάρμακον_
ἀνῆκεν	verb_verb_	ἀνήκω_ἀνίημι_
Μαλέαν	noun_noun_	Μαλέη_Μαλέα_
Θάλητα	noun_noun_	Θαλήτας_Θάλης_
δίχα	verb_adverb_	διχάω_δίχα_
ἄντην	verb_adverb_noun_	ἀντάω_ἄντην_ἄντη_
ἐδόκουν	verb_verb_	δοκόω_δοκέω_
ἔρρεεν	verb_verb_	ῥέω_ἔρρω_
Κῶν	verb_noun_	κέω_Κῶς_
φάρε᾽	noun_noun_	φᾶρος_φάρος_
ἡττημένον	verb_verb_	ἡττάω_ἡσσάομαι_
Ἀλέξανδρος	noun_adjective_	Ἀλέξανδρος_ἀλέξανδρος_
ἄμα	noun_verb_noun_	ἄμη_ἀμάω1_ἄμπ_
ἔξει	verb_verb_verb_	ἔξειμι2_ἔσσομαι_ξέω_
ὑγιῶς	verb_adjective_	ὑγιόω_ὑγιής_
ποτῷ	adjective_noun_	ποτός_ποτόν_
δαὶ̈ς	noun_noun_	δαίς1_δαίς3_
Δημῶ	noun_noun_	δημός_Δημώ_
ἐννεά	noun_adjective_adjective_	ἐννεάς_ἐνεός_ἐννεός_
Ἀρίσταρχον	noun_noun_	Ἀρίσταρχος_ἀρίσταρχος_
Κράτης	verb_noun_	κρατέω_Κράτης_
σκέπα	noun_noun_verb_noun_	σκέπη_σκέπας_σκεπάω_σκέπος_
ἀϋτῆς	noun_verb_	ἀυτή_ἀυτέω_
Λιτῶν	noun_adjective_noun_	λίς2_λιτός_λιτή_
θεραπείαν	noun_noun_	θεραπεία_θεραπείη_
ἄνθ'	verb_noun_adverb_noun_	ἄντομαι_ἄντη_ἄντα_ἄνθη_
μέσου	noun_adjective_verb_	μέσης_μέσος_μεσόω_
ἀφελῶν	adjective_verb_	ἀφελής_ἀφαιρέω_
Νηλεϊδῶν	noun_noun_	Νηλεύς_Νηλείδης_
γλυκίων	adjective_adjective_	γλυκύς_γλύκιος_
συνθέτων	adjective_verb_	σύνθετος_συντίθημι_
ἀθετήσεις	verb_noun_	ἀθετέω_ἀθέτησις_
Ἄρη	noun_noun_noun_noun_	ἄρος_Ἄρης_Ἄρις_Ἄρευς_
θροῦν	verb_noun_	θρέω_θρόος_
ἔγχεα	noun_verb_	ἔγχος_ἐγχύνω_
ἀπαντᾷ	noun_verb_	ἀπαντή_ἀπαντάω_
πρώτῃσιν	adjective_adjective_	πρῶτος_πρότερος_
Δόλωνα	noun_noun_	δόλων_Δόλων_
λιγέωσ	adverb_adjective_	λιγέως_λιγύς_
δέει	verb_verb_noun_verb_verb_	δέω2_δέω1_δέος_δεῖ_δέομαι_
ἐκπλαγεὶς	verb_verb_	ἐκπλήσσω_ἐκπλάσσω_
ἕως	conjunction_noun_	ἕως_ἠώς_
νεωτέρας	adjective_adjective_	νεώτερος_νέος_
βιασάμενος	verb_verb_	βιάω_βιάζω_
Δαναῶν	noun_noun_	Δαναοί_Δαναός_
ἄγετε	adverb_verb_	ἄγε_ἄγω_
Γῆ	noun_noun_	Γαῖα_γῆ_
σ'	adjective_pronoun_	σός_σύ_
κῶς	particle_noun_	πως_πῶς_
Πλειάδες	noun_noun_	Πλειάδες_Πλειάς_
ναίεσκε	verb_verb_	ναίω1_ναίω2_
οὔρους	noun_noun_noun_noun_noun_	οὖρος1_οὖροσὖρος4_οὐρόσς_οὐρός_οὖρος2_
πρώτῃσι	adjective_adjective_	πρῶτος_πρότερος_
μὰ	noun_particle_	μής_μά_
χίλια	adjective_adjective_	χίλιοι_χίλιος_
λέγετε	verb_verb_verb_	λέγω2_λέγω1_λέγω3_
δίηται	verb_verb_	διίημι_δίω_
ἔλυσας	verb_verb_	ἐλύω_λύω_
ἧς	noun_pronoun_	εἷς_ὅς_
πρῶθ'	adjective_adjective_	πρῶτος_πρότερος_
πολέμου	noun_verb_	πόλεμος_πολεμόω_
ὀμβρίων	adjective_verb_	ὄμβριος_ὀμβρέω_
φυλάσσεσθαι	verb_verb_	φυλάσσω_φυλάζω_
Μαρπήσσης	noun_noun_	Μαρπήσση_Μάρπησσα_
Πολίτης	noun_noun_	πολίτης_Πολίτης_
ὑμῶν	adjective_pronoun_	ὑμός_σύ_
κεχαρισμένων	verb_verb_	χαρίζω_χαρίζομαι_
κἀν	preposition_preposition_	εἰς_ἐν_
διηρημένως	verb_verb_verb_verb_verb_	διά-ἐρέω_διά-ἀράω2_διά-ἐρέομαι_διά-ἀρέομαι_διά-ἐράομαι_
κυρίως	verb_noun_adverb_	κυριόω_κύριος_κυρίως_
ὀνομαστήν	adjective_noun_	ὀνομαστός_ὀνομαστής_
μάχη	noun_verb_	μάχη_μαχάω_
ῥῆξε	verb_verb_	ῥήγνυμι_ῥήσσω_
δοκοῦσι	verb_verb_noun_	δοκέω_δοκόω_δοκώ_
ἐμῶν	verb_adjective_	ἐμέω_ἐμός_
δίῃ	verb_verb_adjective_	διίημι_δίω_δῖος_
κεῖν'	pronoun_adjective_	ἐκεῖνος_κεῖνος_
Ὀδυσσείᾳ	noun_adjective_	Ὀδύσσεια_Ὀδύσσειος_
περονῶν	verb_noun_	περονάω_περόνη_
ἐμποιήσῃ	noun_verb_	ἐμποίησις_ἐμποιέω_
φυλάσσεσθαι	verb_verb_	φυλάσσω_φυλάζω_
ἁπλῶς	verb_adverb_adjective_	ἁπλόω_ἁπλῶς_ἁπλός_
τυραννίων	verb_verb_	τυραννεύω_τυραννιάω_
ἀλεῖσθαι	verb_verb_verb_	ἀλέω_ἀλέομαι_ἀλάομαι_
ἔκιον	verb_verb_	κέω_κίω_
θέρει	noun_verb_	θέρος_θέρω_
ὁρμᾷ	verb_verb_noun_	ὁρμάζω_ὁρμάω_ὁρμή_
ἀασάμην	verb_verb_	ἀάζω_ἀάω_
ἄπειρα	adjective_adjective_	ἄπειρος2_ἄπειρος1_
οἰηθεῖσ'	verb_verb_	οἴομαι_οἰάω_
ἐΐσης	adjective_adjective_	ἔισος_ἴσος_
μέθυσε	verb_adjective_	μεθύσκω_μέθυσος_
ὑγρῷ	verb_adjective_	ὑγράζω_ὑγρός_
σχεῖν	verb_verb_	σχάω_ἔχω_
πηγῇς	adjective_verb_noun_verb_	πηγός_πηγάζω_πηγή_πήσσω_
Ἴ¨λιον	noun_noun_adjective_adjective_	Ἴλιος_Ἴλιον_Ἴλι_Ἴλιοσλιος_
ἀνδρεῖα	adjective_noun_	ἀνδρεῖος_ἀνδρεῖα_
τελείων	verb_verb_adjective_	τελειόω_τελέω_τέλειος_
ἰδέαι	verb_noun_	ἰδέω_ἰδέα_
Περσῶν	noun_verb_	Πέρσης_πέρθω_
κεῖσε	adverb_adverb_	κεῖσε_ἐκεῖσε_
ἄρσω	verb_verb_noun_	ἀραρίσκω_ἄρδω_ἄρσης_
Πυλίους	noun_adjective_	Πύλιοι_Πύλιος_
πολέμω	verb_noun_	πολεμόω_πόλεμος_
Βορέης	noun_noun_	Βορέας_Βορέης_
Ἀσκληπιάδῃ	noun_noun_	Ἀσκληπιάδης_Ἀσκληπιάδαι_
δέξαι	verb_verb_	δείκνυμι_δέχομαι_
κοῖος	adjective_adjective_	κοῖος_ποῖος_
ἄσαι	verb_noun_verb_	ἀάω_ἄση_ἄω3_
καρπὸν	noun_noun_	καρπός1_καρπός2_
ἀζαλέην	adjective_noun_	ἀζαλέος_ἀζαλέα_
μάχην	noun_verb_	μάχη_μαχάω_
Μυσίας	verb_noun_adjective_	μυσιάω_μυσία_Μύσιος_
κηρὶ	noun_noun_	κηρίς_κήρ_
δοιῇ	verb_noun_	δοιάζω_δοιή_
γένετ'	verb_noun_	γίγνομαι_γενέτης_
εἷπε	noun_verb_	εἶπος_εἶπον_
διπλῶ	verb_verb_adjective_adjective_	διπλάζω_διπλόω_διπλός_διπλόος_
μελαίναις	noun_adjective_	μέλαινα_μέλας_
Δόλωνος	noun_noun_	δόλων_Δόλων_
κρίνει	verb_noun_	κρίνω_κρίνον_
τίμησον	verb_verb_	τιμάω_τιμέω_
ὑστέρου	noun_adjective_	ὕστερον_ὕστερος_
πιθανῶς	adjective_verb_	πιθανός_πιθανόω_
τοὶ	pronoun_article_particle_	σύ_ὁ_τοι_
ψεύδεσσι	noun_noun_	ψεῦδις_ψεῦδος_
φθάσει	verb_verb_	φθάνω_φθάζω_
βουλέων	noun_noun_	βουλή_βουλεύς_
λεία	noun_adjective_	λεία_λεῖος_
εἴσομαι	verb_verb_	οἶδα_εἶμι_
ἐμῆς	adjective_verb_	ἐμός_ἐμέω_
εὕρ'	verb_noun_	εὑρίσκω_εὑραί_
ἀρίστοις	noun_adjective_	ἄριστον_ἄριστος_
ἡγεῖτ'	verb_verb_	ἡγέομαι_ἁγέομαι_
τετεύχατο	verb_verb_	τεύχω_τυγχάνω_
μικρὸς	adjective_adjective_	σμικρός_μικρός_
μανία	verb_noun_noun_	μανιάω_μανίον_μανία_
σωφροσύνην	noun_adjective_	σωφροσύνη_σωφρόσυνος_
Ἀχελῴου	noun_noun_	Ἀχελῷος_Ἀχελώιος_
χρήσει	noun_verb_	χρῆσις_χράω2_
Ἀριστόνικος	adjective_noun_	ἀριστόνικος_Ἀριστόνικος_
ὄρυξιν	noun_noun_	ὄρυξις_ὄρυξ_
σάρκα	noun_verb_	σάρξ_σαρκάω_
ὁρμώντων	verb_verb_	ὁρμάω_ὁρμάζω_
ὁρμήσειε	verb_verb_	ὁρμάω_ὁρμέω_
Ὀλύμπια	adjective_noun_noun_	Ὀλύμπιος_Ὀλυμπιεῖον_Ὀλύμπια_
ἀνάσσει	verb_verb_	ἀνάζω_ἀνάσσω_
μιγεῖς	adjective_verb_	μιγής_μίγνυμι_
τετράποδα	adjective_adjective_	τετράποδος_τετράπους_
Χαρίτεσσι	noun_noun_	Χάρις_χάρις_
νεκροῦ	verb_adjective_	νεκρόω_νεκρός_
ποιοῦσιν	verb_verb_	ποιέω_ποιόω_
νοοῦ	verb_verb_	νοόω_νοέω_
ῥύπον	noun_noun_	ῥύπον_ῥύπος_
ἐξίστησιν	verb_verb_	ἐξίστημι_ἐξιστάω_
κοτέοντος	verb_verb_	κοτέω_κοτάω_
δαΐ	particle_noun_	δαί_δαίς1_
ὁμῇ	adverb_adjective_	ὁμῇ_ὁμός_
τρύγην	verb_noun_noun_	τρυγάω_τρύγος_τρύγη_
ἰοῦσαν	verb_verb_verb_	εἰμί_ἰόω_εἶμι_
Βοώτου	noun_noun_	Βοώτης_βοώτης_
ἤρας	verb_noun_verb_	ἐράω2_ἤρα_ἐράω1_
δεξάμενος	verb_verb_	δέχομαι_δείκνυμι_
μεταγενεστέρων	adjective_adjective_	μεταγενέστερος_μεταγενής_
εἴσω	verb_adverb_	εἴδομαι_εἴσω_
ἰστέον	adjective_adjective_	ἰστέος_ἰστέον_
ἔᾰ	verb_exclamation_verb_	εἰμί_ἔα_ἐάω_
τάφους	noun_noun_	τάφος1_τάφος2_
ὤτων	adjective_adjective_	ἆτος_ἄατος_
γονῆς	noun_noun_verb_	γονεύς_γονή_γονάω_
ὑπέσχου	verb_verb_	ὑπέχω_ὑπισχνέομαι_
πέπλος	adjective_noun_	πεπλος_πέπλος_
παραυτὰ	adverb_adverb_	παραυτά_πάραυτα_
ἔρεξ'	verb_verb_	ῥέζω_ἐρέσσω_
φρίσσειν	verb_verb_	φρίσσω_φρίζω_
ἐλίσσουσι	verb_verb_	ἐλίσσω_ἑλίσσω_
ἄγει	verb_noun_verb_	ἀγάω_ἄγος_ἄγω_
προηγουμένως	adverb_verb_	προηγουμένως_προηγέομαι_
τῶ	adverb_article_	τῷ_ὁ_
Δίου	verb_verb_adjective_noun_noun_	δίεμαι_δίω_δῖος_Δίον_Δῖος_
σάρκας	verb_noun_	σαρκάω_σάρξ_
ἀπονήσεται	verb_verb_verb_	ἀπονίναμαι_ἀπονέομαι_ἀπονέω_
φροντίσι	noun_noun_	φρόντισις_φροντίς_
ἐρρωμένου	verb_adjective_	ῥώννυμι_ἐρρωμένος_
πρώτως	adjective_adverb_adjective_	πρότερος_πρώτως_πρῶτος_
κἀκεῖ	verb_adverb_verb_	ἀκέομαι_ἐκεῖ_ἀκέω_
Κρόνῳ	noun_noun_	κρόνος_Κρόνος_
ξύλων	verb_noun_	ξυλόω_ξύλον_
παῖς	noun_adjective_	παῖς_πᾶς_
κακῶσ	verb_adjective_	κακόω_κακός_
Σκαιαὶ	noun_noun_adjective_adjective_	Σκαιαί_Σκαίη_Σκαιός_σκαιός_
διπλῇ	verb_adverb_adjective_adjective_	διπλάζω_διπλῇ_διπλός_διπλόος_
οἰνοχόη	noun_verb_	οἰνοχόη_οἰνοχοέω_
ἀργὰ	adjective_adjective_	ἀργός1_ἀργός2_
χαρίζομαι	verb_verb_	χαρίζομαι_χαρίζω_
βέομαι	verb_verb_	βαίνω_βέομαι_
θέω	verb_noun_verb_	τίθημι_θεον_θέω_
γνῶσιν	noun_verb_	γνῶσις_γιγνώσκω_
μαλακοῖσιν	verb_adjective_	μαλακόω_μαλακός_
πρόκα	adverb_noun_	πρόκα_πρόξ_
οὐδὲ̀	noun_noun_particle_	οὐδός2_οὐδός1_οὐδέ_
παρωσάμενος	verb_verb_	παρωθέω_παρόω_
ἐπῴχατο	verb_verb_verb_	ἐπί-ὠίζω_ἐπί-οἴγω_ἐπί-ὀίζω_
ὑποδεξίη	noun_adjective_	ὑποδεξίη_ὑποδέξιος_
ἔραζε	adverb_verb_verb_	ἔραζε_ῥάζω_ῥαίνω_
ἰόντες	verb_verb_	εἶμι_εἰμί_
ἀλωῆς	noun_noun_	ἀλωή_ἀλωεύς_
Ἔννομον	adjective_noun_	ἔννομος_Ἔννομος_
ἔπαυον	verb_verb_	ἐπαύω_παύω_
πῆξαι	verb_verb_	πήσσω_πήγνυμι_
οἰκητήριον	adjective_noun_	οἰκητήριος_οἰκητήριον_
πάσσε	verb_noun_verb_	πάσσω_πάσσος_πατέομαι_
λάμπ'	noun_verb_	λάμπη_λάμπω_
ἢ	exclamation_conjunction_	ἤ2_ἤ1_
ἰ¨όντα	verb_verb_	εἶμι_εἰμί_
Γλαῦκος	noun_noun_noun_noun_	Γλαῦκος_γλαύξ_γλαῦκος_Γλαύκος_
μετ'	adverb_preposition_	μεταί_μετά_
Κόων	noun_verb_noun_	κόος_κοάω_Κόων_
φευξομένους	verb_verb_	φεύζω_φεύγω_
λίμνῃ	noun_noun_	λιμνει_λίμνη_
βραχίονα	noun_adjective_	βραχίων_βραχύς_
λεγομένη	verb_verb_verb_	λέγω2_λέγω1_λέγω3_
λέγονται	verb_verb_verb_	λέγω3_λέγω2_λέγω1_
ἐπίσκοπον	noun_adjective_	ἐπίσκοπος1_ἐπίσκοπος2_
ποιηταί	adjective_noun_	ποιητός_ποιητής_
Βούτα	noun_noun_	βούτης_Βούτης_
δαψιλῶς	adjective_adjective_	δαψιλός_δαψιλής_
ἀνδρὶ	noun_noun_	ἀνήρ_ἀνδρίς_
ῥήξας	verb_verb_	ῥήγνυμι_ῥήσσω_
